PokerStars Hand #185451064870: Tournament #2282606587, $13.37+$1.63 USD Hold'em No Limit - Level I (15/30) - 2018/04/20 8:02:08 ET
Table '2282606587 6' 9-max Seat #1 is the button
Seat 1: MR50FIFTY (3000 in chips) 
Seat 2: MalyshauFish (3000 in chips) 
Seat 3: LosGansos (3000 in chips) 
Seat 4: starbase5 (3000 in chips) 
Seat 5: wemax (3000 in chips) 
Seat 6: coldpuck (3000 in chips) 
Seat 7: tuborg123456 (3000 in chips) 
Seat 8: ollikahn23 (3000 in chips) 
MR50FIFTY: posts the ante 4
MalyshauFish: posts the ante 4
LosGansos: posts the ante 4
starbase5: posts the ante 4
wemax: posts the ante 4
coldpuck: posts the ante 4
tuborg123456: posts the ante 4
ollikahn23: posts the ante 4
MalyshauFish: posts small blind 15
LosGansos: posts big blind 30
*** HOLE CARDS ***
Dealt to ollikahn23 [Tc 9c]
starbase5: folds 
wemax: raises 60 to 90
coldpuck has timed out
coldpuck: folds 
coldpuck is sitting out
tuborg123456: calls 90
ollikahn23: calls 90
MR50FIFTY: folds 
MalyshauFish: folds 
LosGansos: folds 
*** FLOP *** [Jh 5d 5c]
wemax: checks 
tuborg123456: checks 
ollikahn23: bets 115
wemax: calls 115
tuborg123456: folds 
*** TURN *** [Jh 5d 5c] [Js]
wemax: checks 
ollikahn23: checks 
*** RIVER *** [Jh 5d 5c Js] [4c]
wemax: checks 
ollikahn23: checks 
*** SHOW DOWN ***
wemax: shows [Kh Ad] (two pair, Jacks and Fives)
ollikahn23: mucks hand 
wemax collected 577 from pot
*** SUMMARY ***
Total pot 577 | Rake 0 
Board [Jh 5d 5c Js 4c]
Seat 1: MR50FIFTY (button) folded before Flop (didn't bet)
Seat 2: MalyshauFish (small blind) folded before Flop
Seat 3: LosGansos (big blind) folded before Flop
Seat 4: starbase5 folded before Flop (didn't bet)
Seat 5: wemax showed [Kh Ad] and won (577) with two pair, Jacks and Fives
Seat 6: coldpuck folded before Flop (didn't bet)
Seat 7: tuborg123456 folded on the Flop
Seat 8: ollikahn23 mucked [Tc 9c]



PokerStars Hand #185451116123: Tournament #2282606587, $13.37+$1.63 USD Hold'em No Limit - Level I (15/30) - 2018/04/20 8:04:17 ET
Table '2282606587 6' 9-max Seat #2 is the button
Seat 1: MR50FIFTY (2996 in chips) 
Seat 2: MalyshauFish (2981 in chips) 
Seat 3: LosGansos (2966 in chips) 
Seat 5: wemax (3368 in chips) 
Seat 6: coldpuck (2996 in chips) is sitting out
Seat 7: tuborg123456 (2906 in chips) 
Seat 8: ollikahn23 (2791 in chips) 
Seat 9: Flash7772323 (3000 in chips) 
MR50FIFTY: posts the ante 4
MalyshauFish: posts the ante 4
LosGansos: posts the ante 4
wemax: posts the ante 4
coldpuck: posts the ante 4
tuborg123456: posts the ante 4
ollikahn23: posts the ante 4
Flash7772323: posts the ante 4
LosGansos: posts small blind 15
wemax: posts big blind 30
*** HOLE CARDS ***
Dealt to ollikahn23 [Ks Ah]
coldpuck: folds 
tuborg123456: folds 
ollikahn23: raises 60 to 90
Flash7772323: folds 
MR50FIFTY: folds 
MalyshauFish: calls 90
LosGansos: folds 
wemax: folds 
*** FLOP *** [3h Qc 6d]
ollikahn23: bets 90
MalyshauFish: calls 90
*** TURN *** [3h Qc 6d] [Kd]
coldpuck has returned
ollikahn23: checks 
MalyshauFish: bets 219
ollikahn23: calls 219
*** RIVER *** [3h Qc 6d Kd] [4c]
ollikahn23: checks 
MalyshauFish: checks 
*** SHOW DOWN ***
ollikahn23: shows [Ks Ah] (a pair of Kings)
MalyshauFish: mucks hand 
ollikahn23 collected 875 from pot
*** SUMMARY ***
Total pot 875 | Rake 0 
Board [3h Qc 6d Kd 4c]
Seat 1: MR50FIFTY folded before Flop (didn't bet)
Seat 2: MalyshauFish (button) mucked [Tc Qs]
Seat 3: LosGansos (small blind) folded before Flop
Seat 5: wemax (big blind) folded before Flop
Seat 6: coldpuck folded before Flop (didn't bet)
Seat 7: tuborg123456 folded before Flop (didn't bet)
Seat 8: ollikahn23 showed [Ks Ah] and won (875) with a pair of Kings
Seat 9: Flash7772323 folded before Flop (didn't bet)



PokerStars Hand #185451141996: Tournament #2282606587, $13.37+$1.63 USD Hold'em No Limit - Level I (15/30) - 2018/04/20 8:05:22 ET
Table '2282606587 6' 9-max Seat #3 is the button
Seat 1: MR50FIFTY (2992 in chips) 
Seat 2: MalyshauFish (2578 in chips) 
Seat 3: LosGansos (2947 in chips) 
Seat 4: 1111101000 (3000 in chips) out of hand (moved from another table into small blind)
Seat 5: wemax (3334 in chips) 
Seat 6: coldpuck (2992 in chips) 
Seat 7: tuborg123456 (2902 in chips) 
Seat 8: ollikahn23 (3263 in chips) 
Seat 9: Flash7772323 (2996 in chips) 
1111101000 will be allowed to play after the button
MR50FIFTY: posts the ante 4
MalyshauFish: posts the ante 4
LosGansos: posts the ante 4
wemax: posts the ante 4
coldpuck: posts the ante 4
tuborg123456: posts the ante 4
ollikahn23: posts the ante 4
Flash7772323: posts the ante 4
wemax: posts small blind 15
coldpuck: posts big blind 30
*** HOLE CARDS ***
Dealt to ollikahn23 [8d 9h]
tuborg123456: folds 
ollikahn23: folds 
Flash7772323: folds 
MR50FIFTY: raises 60 to 90
MalyshauFish: folds 
LosGansos: calls 90
wemax: folds 
coldpuck: folds 
*** FLOP *** [4s 8h 4c]
MR50FIFTY: bets 240
LosGansos: folds 
Uncalled bet (240) returned to MR50FIFTY
MR50FIFTY collected 257 from pot
MR50FIFTY: doesn't show hand 
*** SUMMARY ***
Total pot 257 | Rake 0 
Board [4s 8h 4c]
Seat 1: MR50FIFTY collected (257)
Seat 2: MalyshauFish folded before Flop (didn't bet)
Seat 3: LosGansos (button) folded on the Flop
Seat 5: wemax (small blind) folded before Flop
Seat 6: coldpuck (big blind) folded before Flop
Seat 7: tuborg123456 folded before Flop (didn't bet)
Seat 8: ollikahn23 folded before Flop (didn't bet)
Seat 9: Flash7772323 folded before Flop (didn't bet)



PokerStars Hand #185451164466: Tournament #2282606587, $13.37+$1.63 USD Hold'em No Limit - Level I (15/30) - 2018/04/20 8:06:18 ET
Table '2282606587 6' 9-max Seat #5 is the button
Seat 1: MR50FIFTY (3155 in chips) 
Seat 2: MalyshauFish (2574 in chips) 
Seat 3: LosGansos (2853 in chips) 
Seat 4: 1111101000 (3000 in chips) 
Seat 5: wemax (3315 in chips) 
Seat 6: coldpuck (2958 in chips) 
Seat 7: tuborg123456 (2898 in chips) 
Seat 8: ollikahn23 (3259 in chips) 
Seat 9: Flash7772323 (2992 in chips) 
MR50FIFTY: posts the ante 4
MalyshauFish: posts the ante 4
LosGansos: posts the ante 4
1111101000: posts the ante 4
wemax: posts the ante 4
coldpuck: posts the ante 4
tuborg123456: posts the ante 4
ollikahn23: posts the ante 4
Flash7772323: posts the ante 4
coldpuck: posts small blind 15
tuborg123456: posts big blind 30
*** HOLE CARDS ***
Dealt to ollikahn23 [Jh Qc]
ollikahn23: folds 
Flash7772323: folds 
MR50FIFTY: folds 
MalyshauFish: folds 
LosGansos: calls 30
1111101000: raises 72 to 102
wemax: folds 
coldpuck: calls 87
tuborg123456: raises 378 to 480
LosGansos: folds 
1111101000: calls 378
coldpuck: calls 378
*** FLOP *** [5c Ah Jc]
coldpuck: checks 
tuborg123456: bets 633
1111101000: calls 633
coldpuck: folds 
*** TURN *** [5c Ah Jc] [4d]
tuborg123456: bets 1781 and is all-in
1111101000: calls 1781
*** RIVER *** [5c Ah Jc 4d] [9c]
*** SHOW DOWN ***
tuborg123456: shows [Ad Ks] (a pair of Aces)
1111101000: shows [Ac 8c] (a flush, Ace high)
1111101000 collected 6334 from pot
tuborg123456 finished the tournament
*** SUMMARY ***
Total pot 6334 | Rake 0 
Board [5c Ah Jc 4d 9c]
Seat 1: MR50FIFTY folded before Flop (didn't bet)
Seat 2: MalyshauFish folded before Flop (didn't bet)
Seat 3: LosGansos folded before Flop
Seat 4: 1111101000 showed [Ac 8c] and won (6334) with a flush, Ace high
Seat 5: wemax (button) folded before Flop (didn't bet)
Seat 6: coldpuck (small blind) folded on the Flop
Seat 7: tuborg123456 (big blind) showed [Ad Ks] and lost with a pair of Aces
Seat 8: ollikahn23 folded before Flop (didn't bet)
Seat 9: Flash7772323 folded before Flop (didn't bet)



PokerStars Hand #185451200162: Tournament #2282606587, $13.37+$1.63 USD Hold'em No Limit - Level I (15/30) - 2018/04/20 8:07:48 ET
Table '2282606587 6' 9-max Seat #6 is the button
Seat 1: MR50FIFTY (3151 in chips) 
Seat 2: MalyshauFish (2570 in chips) 
Seat 3: LosGansos (2819 in chips) 
Seat 4: 1111101000 (6436 in chips) 
Seat 5: wemax (3311 in chips) 
Seat 6: coldpuck (2474 in chips) 
Seat 8: ollikahn23 (3255 in chips) 
Seat 9: Flash7772323 (2988 in chips) 
MR50FIFTY: posts the ante 4
MalyshauFish: posts the ante 4
LosGansos: posts the ante 4
1111101000: posts the ante 4
wemax: posts the ante 4
coldpuck: posts the ante 4
ollikahn23: posts the ante 4
Flash7772323: posts the ante 4
ollikahn23: posts small blind 15
Flash7772323: posts big blind 30
*** HOLE CARDS ***
Dealt to ollikahn23 [5d Qh]
MR50FIFTY: folds 
MalyshauFish: folds 
LosGansos: raises 60 to 90
1111101000: folds 
wemax: folds 
coldpuck: calls 90
ollikahn23: folds 
Flash7772323: folds 
*** FLOP *** [Ah Ts 6s]
LosGansos: bets 120
coldpuck: calls 120
*** TURN *** [Ah Ts 6s] [Td]
LosGansos: bets 180
coldpuck: folds 
Uncalled bet (180) returned to LosGansos
LosGansos collected 497 from pot
*** SUMMARY ***
Total pot 497 | Rake 0 
Board [Ah Ts 6s Td]
Seat 1: MR50FIFTY folded before Flop (didn't bet)
Seat 2: MalyshauFish folded before Flop (didn't bet)
Seat 3: LosGansos collected (497)
Seat 4: 1111101000 folded before Flop (didn't bet)
Seat 5: wemax folded before Flop (didn't bet)
Seat 6: coldpuck (button) folded on the Turn
Seat 8: ollikahn23 (small blind) folded before Flop
Seat 9: Flash7772323 (big blind) folded before Flop



PokerStars Hand #185451221330: Tournament #2282606587, $13.37+$1.63 USD Hold'em No Limit - Level I (15/30) - 2018/04/20 8:08:41 ET
Table '2282606587 6' 9-max Seat #8 is the button
Seat 1: MR50FIFTY (3147 in chips) 
Seat 2: MalyshauFish (2566 in chips) 
Seat 4: 1111101000 (6432 in chips) 
Seat 5: wemax (3307 in chips) 
Seat 6: coldpuck (2260 in chips) 
Seat 7: WLAXeeee (3000 in chips) 
Seat 8: ollikahn23 (3236 in chips) 
Seat 9: Flash7772323 (2954 in chips) 
MR50FIFTY: posts the ante 4
MalyshauFish: posts the ante 4
1111101000: posts the ante 4
wemax: posts the ante 4
coldpuck: posts the ante 4
WLAXeeee: posts the ante 4
ollikahn23: posts the ante 4
Flash7772323: posts the ante 4
Flash7772323: posts small blind 15
MR50FIFTY: posts big blind 30
*** HOLE CARDS ***
Dealt to ollikahn23 [Kh Qs]
MalyshauFish: folds 
1111101000: folds 
wemax: folds 
coldpuck: folds 
WLAXeeee: raises 60 to 90
ollikahn23: raises 60 to 150
Flash7772323: folds 
MR50FIFTY: folds 
WLAXeeee: calls 60
*** FLOP *** [Ks 5s Ac]
WLAXeeee: checks 
ollikahn23: checks 
*** TURN *** [Ks 5s Ac] [7h]
WLAXeeee: bets 120
ollikahn23: calls 120
*** RIVER *** [Ks 5s Ac 7h] [Jc]
WLAXeeee: bets 540
ollikahn23: folds 
Uncalled bet (540) returned to WLAXeeee
WLAXeeee collected 617 from pot
*** SUMMARY ***
Total pot 617 | Rake 0 
Board [Ks 5s Ac 7h Jc]
Seat 1: MR50FIFTY (big blind) folded before Flop
Seat 2: MalyshauFish folded before Flop (didn't bet)
Seat 4: 1111101000 folded before Flop (didn't bet)
Seat 5: wemax folded before Flop (didn't bet)
Seat 6: coldpuck folded before Flop (didn't bet)
Seat 7: WLAXeeee collected (617)
Seat 8: ollikahn23 (button) folded on the River
Seat 9: Flash7772323 (small blind) folded before Flop



PokerStars Hand #185451246350: Tournament #2282606587, $13.37+$1.63 USD Hold'em No Limit - Level I (15/30) - 2018/04/20 8:09:44 ET
Table '2282606587 6' 9-max Seat #9 is the button
Seat 1: MR50FIFTY (3113 in chips) 
Seat 2: MalyshauFish (2562 in chips) 
Seat 3: SilentWil (3000 in chips) 
Seat 4: 1111101000 (6428 in chips) 
Seat 5: wemax (3303 in chips) 
Seat 6: coldpuck (2256 in chips) 
Seat 7: WLAXeeee (3343 in chips) 
Seat 8: ollikahn23 (2962 in chips) 
Seat 9: Flash7772323 (2935 in chips) 
MR50FIFTY: posts the ante 4
MalyshauFish: posts the ante 4
SilentWil: posts the ante 4
1111101000: posts the ante 4
wemax: posts the ante 4
coldpuck: posts the ante 4
WLAXeeee: posts the ante 4
ollikahn23: posts the ante 4
Flash7772323: posts the ante 4
MR50FIFTY: posts small blind 15
MalyshauFish: posts big blind 30
*** HOLE CARDS ***
Dealt to ollikahn23 [Jc Th]
SilentWil: calls 30
1111101000: folds 
wemax: folds 
coldpuck: raises 30 to 60
WLAXeeee: folds 
ollikahn23: calls 60
Flash7772323: folds 
MR50FIFTY: folds 
MalyshauFish: raises 180 to 240
SilentWil: calls 210
coldpuck: calls 180
ollikahn23: calls 180
*** FLOP *** [Qd 2c Kd]
MalyshauFish: checks 
SilentWil: checks 
coldpuck: checks 
ollikahn23: checks 
*** TURN *** [Qd 2c Kd] [5s]
MalyshauFish: bets 674
SilentWil: folds 
coldpuck: folds 
ollikahn23: folds 
Uncalled bet (674) returned to MalyshauFish
MalyshauFish collected 1011 from pot
MalyshauFish: doesn't show hand 
*** SUMMARY ***
Total pot 1011 | Rake 0 
Board [Qd 2c Kd 5s]
Seat 1: MR50FIFTY (small blind) folded before Flop
Seat 2: MalyshauFish (big blind) collected (1011)
Seat 3: SilentWil folded on the Turn
Seat 4: 1111101000 folded before Flop (didn't bet)
Seat 5: wemax folded before Flop (didn't bet)
Seat 6: coldpuck folded on the Turn
Seat 7: WLAXeeee folded before Flop (didn't bet)
Seat 8: ollikahn23 folded on the Turn
Seat 9: Flash7772323 (button) folded before Flop (didn't bet)



PokerStars Hand #185451292943: Tournament #2282606587, $13.37+$1.63 USD Hold'em No Limit - Level I (15/30) - 2018/04/20 8:11:40 ET
Table '2282606587 6' 9-max Seat #1 is the button
Seat 1: MR50FIFTY (3094 in chips) 
Seat 2: MalyshauFish (3329 in chips) 
Seat 4: 1111101000 (6424 in chips) 
Seat 5: wemax (3299 in chips) 
Seat 6: coldpuck (2012 in chips) 
Seat 7: WLAXeeee (3339 in chips) 
Seat 8: ollikahn23 (2718 in chips) 
Seat 9: Flash7772323 (2931 in chips) 
MR50FIFTY: posts the ante 4
MalyshauFish: posts the ante 4
1111101000: posts the ante 4
wemax: posts the ante 4
coldpuck: posts the ante 4
WLAXeeee: posts the ante 4
ollikahn23: posts the ante 4
Flash7772323: posts the ante 4
MalyshauFish: posts small blind 15
1111101000: posts big blind 30
*** HOLE CARDS ***
Dealt to ollikahn23 [5c Kh]
wemax: folds 
coldpuck: folds 
WLAXeeee: folds 
ollikahn23: folds 
Flash7772323: raises 47 to 77
MR50FIFTY: calls 77
MalyshauFish: calls 62
1111101000: calls 47
*** FLOP *** [Ad 4d 3d]
MalyshauFish: checks 
1111101000: checks 
Flash7772323: bets 150
MR50FIFTY: calls 150
MalyshauFish: calls 150
1111101000: folds 
*** TURN *** [Ad 4d 3d] [Kd]
MalyshauFish: checks 
Flash7772323: checks 
MR50FIFTY: bets 390
MalyshauFish: calls 390
Flash7772323: folds 
*** RIVER *** [Ad 4d 3d Kd] [4s]
MalyshauFish: checks 
MR50FIFTY: bets 2473 and is all-in
MalyshauFish: calls 2473
*** SHOW DOWN ***
MR50FIFTY: shows [6s Ac] (two pair, Aces and Fours)
MalyshauFish: shows [Tc Qd] (a flush, Ace high)
MalyshauFish collected 6516 from pot
MR50FIFTY finished the tournament
*** SUMMARY ***
Total pot 6516 | Rake 0 
Board [Ad 4d 3d Kd 4s]
Seat 1: MR50FIFTY (button) showed [6s Ac] and lost with two pair, Aces and Fours
Seat 2: MalyshauFish (small blind) showed [Tc Qd] and won (6516) with a flush, Ace high
Seat 4: 1111101000 (big blind) folded on the Flop
Seat 5: wemax folded before Flop (didn't bet)
Seat 6: coldpuck folded before Flop (didn't bet)
Seat 7: WLAXeeee folded before Flop (didn't bet)
Seat 8: ollikahn23 folded before Flop (didn't bet)
Seat 9: Flash7772323 folded on the Turn



PokerStars Hand #185451334365: Tournament #2282606587, $13.37+$1.63 USD Hold'em No Limit - Level II (20/40) - 2018/04/20 8:13:23 ET
Table '2282606587 6' 9-max Seat #2 is the button
Seat 2: MalyshauFish (6751 in chips) 
Seat 3: Jarod Prete (3000 in chips) out of hand (moved from another table into small blind)
Seat 4: 1111101000 (6343 in chips) 
Seat 5: wemax (3295 in chips) 
Seat 6: coldpuck (2008 in chips) 
Seat 7: WLAXeeee (3335 in chips) 
Seat 8: ollikahn23 (2714 in chips) 
Seat 9: Flash7772323 (2700 in chips) 
Jarod Prete will be allowed to play after the button
MalyshauFish: posts the ante 5
1111101000: posts the ante 5
wemax: posts the ante 5
coldpuck: posts the ante 5
WLAXeeee: posts the ante 5
ollikahn23: posts the ante 5
Flash7772323: posts the ante 5
1111101000: posts small blind 20
wemax: posts big blind 40
*** HOLE CARDS ***
Dealt to ollikahn23 [Jd Qd]
coldpuck: folds 
WLAXeeee: folds 
ollikahn23: raises 60 to 100
Flash7772323: folds 
MalyshauFish: calls 100
1111101000: folds 
wemax: calls 60
*** FLOP *** [Th Qc 3d]
wemax: checks 
ollikahn23: bets 200
MalyshauFish: folds 
wemax: folds 
Uncalled bet (200) returned to ollikahn23
ollikahn23 collected 355 from pot
ollikahn23: doesn't show hand 
*** SUMMARY ***
Total pot 355 | Rake 0 
Board [Th Qc 3d]
Seat 2: MalyshauFish (button) folded on the Flop
Seat 4: 1111101000 (small blind) folded before Flop
Seat 5: wemax (big blind) folded on the Flop
Seat 6: coldpuck folded before Flop (didn't bet)
Seat 7: WLAXeeee folded before Flop (didn't bet)
Seat 8: ollikahn23 collected (355)
Seat 9: Flash7772323 folded before Flop (didn't bet)



PokerStars Hand #185451353913: Tournament #2282606587, $13.37+$1.63 USD Hold'em No Limit - Level II (20/40) - 2018/04/20 8:14:11 ET
Table '2282606587 6' 9-max Seat #4 is the button
Seat 1: eqmegz (3000 in chips) 
Seat 2: MalyshauFish (6646 in chips) 
Seat 3: Jarod Prete (3000 in chips) 
Seat 4: 1111101000 (6318 in chips) 
Seat 5: wemax (3190 in chips) 
Seat 6: coldpuck (2003 in chips) 
Seat 7: WLAXeeee (3330 in chips) 
Seat 8: ollikahn23 (2964 in chips) 
Seat 9: Flash7772323 (2695 in chips) 
eqmegz: posts the ante 5
MalyshauFish: posts the ante 5
Jarod Prete: posts the ante 5
1111101000: posts the ante 5
wemax: posts the ante 5
coldpuck: posts the ante 5
WLAXeeee: posts the ante 5
ollikahn23: posts the ante 5
Flash7772323: posts the ante 5
wemax: posts small blind 20
coldpuck: posts big blind 40
*** HOLE CARDS ***
Dealt to ollikahn23 [8h 4s]
WLAXeeee: raises 40 to 80
ollikahn23: folds 
Flash7772323: folds 
eqmegz: raises 60 to 140
MalyshauFish: folds 
Jarod Prete: folds 
1111101000: calls 140
wemax: folds 
coldpuck: calls 100
WLAXeeee: calls 60
*** FLOP *** [5s Qd 5c]
coldpuck: checks 
WLAXeeee: checks 
eqmegz: bets 200
1111101000: folds 
coldpuck: calls 200
WLAXeeee: calls 200
*** TURN *** [5s Qd 5c] [2c]
coldpuck: checks 
WLAXeeee: bets 240
eqmegz: calls 240
coldpuck: calls 240
*** RIVER *** [5s Qd 5c 2c] [3s]
coldpuck: checks 
WLAXeeee: checks 
eqmegz: bets 740
coldpuck: calls 740
WLAXeeee: calls 740
*** SHOW DOWN ***
eqmegz: shows [Ad As] (two pair, Aces and Fives)
coldpuck: mucks hand 
WLAXeeee: mucks hand 
eqmegz collected 4165 from pot
*** SUMMARY ***
Total pot 4165 | Rake 0 
Board [5s Qd 5c 2c 3s]
Seat 1: eqmegz showed [Ad As] and won (4165) with two pair, Aces and Fives
Seat 2: MalyshauFish folded before Flop (didn't bet)
Seat 3: Jarod Prete folded before Flop (didn't bet)
Seat 4: 1111101000 (button) folded on the Flop
Seat 5: wemax (small blind) folded before Flop
Seat 6: coldpuck (big blind) mucked [Kc Qh]
Seat 7: WLAXeeee mucked [Tc Qc]
Seat 8: ollikahn23 folded before Flop (didn't bet)
Seat 9: Flash7772323 folded before Flop (didn't bet)



PokerStars Hand #185451408727: Tournament #2282606587, $13.37+$1.63 USD Hold'em No Limit - Level II (20/40) - 2018/04/20 8:16:25 ET
Table '2282606587 6' 9-max Seat #5 is the button
Seat 1: eqmegz (5840 in chips) 
Seat 2: MalyshauFish (6641 in chips) 
Seat 3: Jarod Prete (2995 in chips) 
Seat 4: 1111101000 (6173 in chips) 
Seat 5: wemax (3165 in chips) 
Seat 6: coldpuck (678 in chips) 
Seat 7: WLAXeeee (2005 in chips) 
Seat 8: ollikahn23 (2959 in chips) 
Seat 9: Flash7772323 (2690 in chips) 
eqmegz: posts the ante 5
MalyshauFish: posts the ante 5
Jarod Prete: posts the ante 5
1111101000: posts the ante 5
wemax: posts the ante 5
coldpuck: posts the ante 5
WLAXeeee: posts the ante 5
ollikahn23: posts the ante 5
Flash7772323: posts the ante 5
coldpuck: posts small blind 20
WLAXeeee: posts big blind 40
*** HOLE CARDS ***
Dealt to ollikahn23 [3c 7h]
ollikahn23: folds 
Flash7772323: folds 
eqmegz: folds 
MalyshauFish: folds 
Jarod Prete: raises 40 to 80
1111101000: calls 80
wemax: calls 80
coldpuck: folds 
WLAXeeee: folds 
*** FLOP *** [8s 7d Jd]
Jarod Prete: bets 120
1111101000: raises 240 to 360
wemax: folds 
Jarod Prete: calls 240
*** TURN *** [8s 7d Jd] [3h]
Jarod Prete: checks 
1111101000: bets 724
Jarod Prete: folds 
Uncalled bet (724) returned to 1111101000
1111101000 collected 1065 from pot
1111101000: doesn't show hand 
*** SUMMARY ***
Total pot 1065 | Rake 0 
Board [8s 7d Jd 3h]
Seat 1: eqmegz folded before Flop (didn't bet)
Seat 2: MalyshauFish folded before Flop (didn't bet)
Seat 3: Jarod Prete folded on the Turn
Seat 4: 1111101000 collected (1065)
Seat 5: wemax (button) folded on the Flop
Seat 6: coldpuck (small blind) folded before Flop
Seat 7: WLAXeeee (big blind) folded before Flop
Seat 8: ollikahn23 folded before Flop (didn't bet)
Seat 9: Flash7772323 folded before Flop (didn't bet)



PokerStars Hand #185451441592: Tournament #2282606587, $13.37+$1.63 USD Hold'em No Limit - Level II (20/40) - 2018/04/20 8:17:46 ET
Table '2282606587 6' 9-max Seat #6 is the button
Seat 1: eqmegz (5835 in chips) 
Seat 2: MalyshauFish (6636 in chips) 
Seat 3: Jarod Prete (2550 in chips) 
Seat 4: 1111101000 (6793 in chips) 
Seat 5: wemax (3080 in chips) 
Seat 6: coldpuck (653 in chips) 
Seat 7: WLAXeeee (1960 in chips) 
Seat 8: ollikahn23 (2954 in chips) 
Seat 9: Flash7772323 (2685 in chips) 
eqmegz: posts the ante 5
MalyshauFish: posts the ante 5
Jarod Prete: posts the ante 5
1111101000: posts the ante 5
wemax: posts the ante 5
coldpuck: posts the ante 5
WLAXeeee: posts the ante 5
ollikahn23: posts the ante 5
Flash7772323: posts the ante 5
WLAXeeee: posts small blind 20
ollikahn23: posts big blind 40
*** HOLE CARDS ***
Dealt to ollikahn23 [Qh Ac]
Flash7772323: folds 
eqmegz: folds 
MalyshauFish: folds 
Jarod Prete: raises 54 to 94
1111101000: folds 
wemax: folds 
coldpuck: folds 
WLAXeeee: calls 74
ollikahn23: calls 54
*** FLOP *** [4d 7h 3s]
WLAXeeee: checks 
ollikahn23: checks 
Jarod Prete: bets 298
WLAXeeee: folds 
ollikahn23: folds 
Uncalled bet (298) returned to Jarod Prete
Jarod Prete collected 327 from pot
Jarod Prete: doesn't show hand 
*** SUMMARY ***
Total pot 327 | Rake 0 
Board [4d 7h 3s]
Seat 1: eqmegz folded before Flop (didn't bet)
Seat 2: MalyshauFish folded before Flop (didn't bet)
Seat 3: Jarod Prete collected (327)
Seat 4: 1111101000 folded before Flop (didn't bet)
Seat 5: wemax folded before Flop (didn't bet)
Seat 6: coldpuck (button) folded before Flop (didn't bet)
Seat 7: WLAXeeee (small blind) folded on the Flop
Seat 8: ollikahn23 (big blind) folded on the Flop
Seat 9: Flash7772323 folded before Flop (didn't bet)



PokerStars Hand #185451469514: Tournament #2282606587, $13.37+$1.63 USD Hold'em No Limit - Level II (20/40) - 2018/04/20 8:18:54 ET
Table '2282606587 6' 9-max Seat #7 is the button
Seat 1: eqmegz (5830 in chips) 
Seat 2: MalyshauFish (6631 in chips) 
Seat 3: Jarod Prete (2778 in chips) 
Seat 4: 1111101000 (6788 in chips) 
Seat 5: wemax (3075 in chips) 
Seat 6: coldpuck (648 in chips) 
Seat 7: WLAXeeee (1861 in chips) 
Seat 8: ollikahn23 (2855 in chips) 
eqmegz: posts the ante 5
MalyshauFish: posts the ante 5
Jarod Prete: posts the ante 5
1111101000: posts the ante 5
wemax: posts the ante 5
coldpuck: posts the ante 5
WLAXeeee: posts the ante 5
ollikahn23: posts the ante 5
ollikahn23: posts small blind 20
eqmegz: posts big blind 40
*** HOLE CARDS ***
Dealt to ollikahn23 [7d 7s]
MalyshauFish: folds 
Jarod Prete: folds 
1111101000: raises 50 to 90
wemax: folds 
coldpuck: calls 90
WLAXeeee: folds 
ollikahn23: calls 70
eqmegz: calls 50
*** FLOP *** [Th 3s As]
ollikahn23: checks 
eqmegz: checks 
1111101000: checks 
coldpuck: bets 553 and is all-in
ollikahn23: folds 
eqmegz: folds 
1111101000: folds 
Uncalled bet (553) returned to coldpuck
coldpuck collected 400 from pot
*** SUMMARY ***
Total pot 400 | Rake 0 
Board [Th 3s As]
Seat 1: eqmegz (big blind) folded on the Flop
Seat 2: MalyshauFish folded before Flop (didn't bet)
Seat 3: Jarod Prete folded before Flop (didn't bet)
Seat 4: 1111101000 folded on the Flop
Seat 5: wemax folded before Flop (didn't bet)
Seat 6: coldpuck collected (400)
Seat 7: WLAXeeee (button) folded before Flop (didn't bet)
Seat 8: ollikahn23 (small blind) folded on the Flop



PokerStars Hand #185451493032: Tournament #2282606587, $13.37+$1.63 USD Hold'em No Limit - Level II (20/40) - 2018/04/20 8:19:51 ET
Table '2282606587 6' 9-max Seat #8 is the button
Seat 1: eqmegz (5735 in chips) 
Seat 2: MalyshauFish (6626 in chips) 
Seat 3: Jarod Prete (2773 in chips) 
Seat 4: 1111101000 (6693 in chips) 
Seat 5: wemax (3070 in chips) 
Seat 6: coldpuck (953 in chips) 
Seat 7: WLAXeeee (1856 in chips) 
Seat 8: ollikahn23 (2760 in chips) 
eqmegz: posts the ante 5
MalyshauFish: posts the ante 5
Jarod Prete: posts the ante 5
1111101000: posts the ante 5
wemax: posts the ante 5
coldpuck: posts the ante 5
WLAXeeee: posts the ante 5
ollikahn23: posts the ante 5
eqmegz: posts small blind 20
MalyshauFish: posts big blind 40
*** HOLE CARDS ***
Dealt to ollikahn23 [9s 7d]
Jarod Prete: folds 
1111101000: raises 97 to 137
wemax: folds 
coldpuck: folds 
WLAXeeee: calls 137
ollikahn23: folds 
eqmegz: folds 
MalyshauFish: calls 97
*** FLOP *** [5d 9c Tc]
MalyshauFish: checks 
1111101000: bets 528
WLAXeeee: calls 528
MalyshauFish: folds 
*** TURN *** [5d 9c Tc] [As]
1111101000: bets 1710
WLAXeeee: folds 
Uncalled bet (1710) returned to 1111101000
1111101000 collected 1527 from pot
1111101000: doesn't show hand 
*** SUMMARY ***
Total pot 1527 | Rake 0 
Board [5d 9c Tc As]
Seat 1: eqmegz (small blind) folded before Flop
Seat 2: MalyshauFish (big blind) folded on the Flop
Seat 3: Jarod Prete folded before Flop (didn't bet)
Seat 4: 1111101000 collected (1527)
Seat 5: wemax folded before Flop (didn't bet)
Seat 6: coldpuck folded before Flop (didn't bet)
Seat 7: WLAXeeee folded on the Turn
Seat 8: ollikahn23 (button) folded before Flop (didn't bet)



PokerStars Hand #185451509492: Tournament #2282606587, $13.37+$1.63 USD Hold'em No Limit - Level II (20/40) - 2018/04/20 8:20:31 ET
Table '2282606587 6' 9-max Seat #1 is the button
Seat 1: eqmegz (5710 in chips) 
Seat 2: MalyshauFish (6484 in chips) 
Seat 3: Jarod Prete (2768 in chips) 
Seat 4: 1111101000 (7550 in chips) 
Seat 5: wemax (3065 in chips) 
Seat 6: coldpuck (948 in chips) 
Seat 7: WLAXeeee (1186 in chips) 
Seat 8: ollikahn23 (2755 in chips) 
eqmegz: posts the ante 5
MalyshauFish: posts the ante 5
Jarod Prete: posts the ante 5
1111101000: posts the ante 5
wemax: posts the ante 5
coldpuck: posts the ante 5
WLAXeeee: posts the ante 5
ollikahn23: posts the ante 5
MalyshauFish: posts small blind 20
Jarod Prete: posts big blind 40
*** HOLE CARDS ***
Dealt to ollikahn23 [7d 8s]
1111101000: folds 
wemax: folds 
coldpuck: raises 80 to 120
WLAXeeee: folds 
ollikahn23: folds 
eqmegz: folds 
MalyshauFish: calls 100
Jarod Prete: calls 80
*** FLOP *** [Th 4d 3h]
MalyshauFish: checks 
Jarod Prete: checks 
coldpuck: bets 400
MalyshauFish: raises 400 to 800
Jarod Prete: folds 
coldpuck: raises 23 to 823 and is all-in
MalyshauFish: calls 23
*** TURN *** [Th 4d 3h] [5h]
*** RIVER *** [Th 4d 3h 5h] [5d]
*** SHOW DOWN ***
MalyshauFish: shows [Jc Tc] (two pair, Tens and Fives)
coldpuck: shows [Kh Kc] (two pair, Kings and Fives)
coldpuck collected 2046 from pot
*** SUMMARY ***
Total pot 2046 | Rake 0 
Board [Th 4d 3h 5h 5d]
Seat 1: eqmegz (button) folded before Flop (didn't bet)
Seat 2: MalyshauFish (small blind) showed [Jc Tc] and lost with two pair, Tens and Fives
Seat 3: Jarod Prete (big blind) folded on the Flop
Seat 4: 1111101000 folded before Flop (didn't bet)
Seat 5: wemax folded before Flop (didn't bet)
Seat 6: coldpuck showed [Kh Kc] and won (2046) with two pair, Kings and Fives
Seat 7: WLAXeeee folded before Flop (didn't bet)
Seat 8: ollikahn23 folded before Flop (didn't bet)



PokerStars Hand #185451535858: Tournament #2282606587, $13.37+$1.63 USD Hold'em No Limit - Level II (20/40) - 2018/04/20 8:21:35 ET
Table '2282606587 6' 9-max Seat #2 is the button
Seat 1: eqmegz (5705 in chips) 
Seat 2: MalyshauFish (5536 in chips) 
Seat 3: Jarod Prete (2643 in chips) 
Seat 4: 1111101000 (7545 in chips) 
Seat 5: wemax (3060 in chips) 
Seat 6: coldpuck (2046 in chips) 
Seat 7: WLAXeeee (1181 in chips) 
Seat 8: ollikahn23 (2750 in chips) 
eqmegz: posts the ante 5
MalyshauFish: posts the ante 5
Jarod Prete: posts the ante 5
1111101000: posts the ante 5
wemax: posts the ante 5
coldpuck: posts the ante 5
WLAXeeee: posts the ante 5
ollikahn23: posts the ante 5
Jarod Prete: posts small blind 20
1111101000: posts big blind 40
*** HOLE CARDS ***
Dealt to ollikahn23 [4c 9d]
wemax: folds 
coldpuck: folds 
WLAXeeee: raises 40 to 80
ollikahn23: folds 
eqmegz: folds 
MalyshauFish: folds 
Jarod Prete: folds 
1111101000: calls 40
*** FLOP *** [5s 8h Td]
1111101000: checks 
WLAXeeee: checks 
*** TURN *** [5s 8h Td] [8s]
1111101000: checks 
WLAXeeee: bets 160
1111101000: folds 
Uncalled bet (160) returned to WLAXeeee
WLAXeeee collected 220 from pot
*** SUMMARY ***
Total pot 220 | Rake 0 
Board [5s 8h Td 8s]
Seat 1: eqmegz folded before Flop (didn't bet)
Seat 2: MalyshauFish (button) folded before Flop (didn't bet)
Seat 3: Jarod Prete (small blind) folded before Flop
Seat 4: 1111101000 (big blind) folded on the Turn
Seat 5: wemax folded before Flop (didn't bet)
Seat 6: coldpuck folded before Flop (didn't bet)
Seat 7: WLAXeeee collected (220)
Seat 8: ollikahn23 folded before Flop (didn't bet)



PokerStars Hand #185451566137: Tournament #2282606587, $13.37+$1.63 USD Hold'em No Limit - Level III (25/50) - 2018/04/20 8:22:47 ET
Table '2282606587 6' 9-max Seat #3 is the button
Seat 1: eqmegz (5700 in chips) 
Seat 2: MalyshauFish (5531 in chips) 
Seat 3: Jarod Prete (2618 in chips) 
Seat 4: 1111101000 (7460 in chips) 
Seat 5: wemax (3055 in chips) 
Seat 6: coldpuck (2041 in chips) 
Seat 7: WLAXeeee (1316 in chips) 
Seat 8: ollikahn23 (2745 in chips) 
eqmegz: posts the ante 6
MalyshauFish: posts the ante 6
Jarod Prete: posts the ante 6
1111101000: posts the ante 6
wemax: posts the ante 6
coldpuck: posts the ante 6
WLAXeeee: posts the ante 6
ollikahn23: posts the ante 6
1111101000: posts small blind 25
wemax: posts big blind 50
*** HOLE CARDS ***
Dealt to ollikahn23 [4c 8c]
coldpuck: folds 
WLAXeeee: raises 100 to 150
ollikahn23: folds 
eqmegz: folds 
MalyshauFish: folds 
Jarod Prete: calls 150
1111101000: folds 
wemax: folds 
*** FLOP *** [7h 4h 7d]
WLAXeeee: bets 200
Jarod Prete: calls 200
*** TURN *** [7h 4h 7d] [5c]
WLAXeeee: checks 
Jarod Prete: checks 
*** RIVER *** [7h 4h 7d 5c] [8h]
WLAXeeee: bets 250
Jarod Prete: calls 250
*** SHOW DOWN ***
WLAXeeee: shows [Js Ah] (a pair of Sevens)
Jarod Prete: shows [Qc Ac] (a pair of Sevens - Ace+Queen kicker)
Jarod Prete collected 1323 from pot
*** SUMMARY ***
Total pot 1323 | Rake 0 
Board [7h 4h 7d 5c 8h]
Seat 1: eqmegz folded before Flop (didn't bet)
Seat 2: MalyshauFish folded before Flop (didn't bet)
Seat 3: Jarod Prete (button) showed [Qc Ac] and won (1323) with a pair of Sevens
Seat 4: 1111101000 (small blind) folded before Flop
Seat 5: wemax (big blind) folded before Flop
Seat 6: coldpuck folded before Flop (didn't bet)
Seat 7: WLAXeeee showed [Js Ah] and lost with a pair of Sevens
Seat 8: ollikahn23 folded before Flop (didn't bet)



PokerStars Hand #185451593600: Tournament #2282606587, $13.37+$1.63 USD Hold'em No Limit - Level III (25/50) - 2018/04/20 8:23:53 ET
Table '2282606587 6' 9-max Seat #4 is the button
Seat 1: eqmegz (5694 in chips) 
Seat 2: MalyshauFish (5525 in chips) 
Seat 3: Jarod Prete (3335 in chips) 
Seat 4: 1111101000 (7429 in chips) 
Seat 5: wemax (2999 in chips) 
Seat 7: WLAXeeee (710 in chips) 
Seat 8: ollikahn23 (2739 in chips) 
Seat 9: 1JORSON (3000 in chips) 
eqmegz: posts the ante 6
MalyshauFish: posts the ante 6
Jarod Prete: posts the ante 6
1111101000: posts the ante 6
wemax: posts the ante 6
WLAXeeee: posts the ante 6
ollikahn23: posts the ante 6
1JORSON: posts the ante 6
wemax: posts small blind 25
WLAXeeee: posts big blind 50
*** HOLE CARDS ***
Dealt to ollikahn23 [4s 9h]
ollikahn23: folds 
1JORSON: folds 
eqmegz: folds 
MalyshauFish: folds 
Jarod Prete: raises 50 to 100
1111101000: folds 
wemax: folds 
WLAXeeee: calls 50
*** FLOP *** [Th 8c Ac]
WLAXeeee: bets 604 and is all-in
Jarod Prete: calls 604
*** TURN *** [Th 8c Ac] [6c]
*** RIVER *** [Th 8c Ac 6c] [Kd]
Jarod Prete said, "ty"
*** SHOW DOWN ***
WLAXeeee: shows [Td Qc] (a pair of Tens)
Jarod Prete: shows [8h Ad] (two pair, Aces and Eights)
Jarod Prete collected 1481 from pot
WLAXeeee finished the tournament
*** SUMMARY ***
Total pot 1481 | Rake 0 
Board [Th 8c Ac 6c Kd]
Seat 1: eqmegz folded before Flop (didn't bet)
Seat 2: MalyshauFish folded before Flop (didn't bet)
Seat 3: Jarod Prete showed [8h Ad] and won (1481) with two pair, Aces and Eights
Seat 4: 1111101000 (button) folded before Flop (didn't bet)
Seat 5: wemax (small blind) folded before Flop
Seat 7: WLAXeeee (big blind) showed [Td Qc] and lost with a pair of Tens
Seat 8: ollikahn23 folded before Flop (didn't bet)
Seat 9: 1JORSON folded before Flop (didn't bet)



PokerStars Hand #185451606784: Tournament #2282606587, $13.37+$1.63 USD Hold'em No Limit - Level III (25/50) - 2018/04/20 8:24:25 ET
Table '2282606587 6' 9-max Seat #5 is the button
Seat 1: eqmegz (5688 in chips) 
Seat 2: MalyshauFish (5519 in chips) 
Seat 3: Jarod Prete (4106 in chips) 
Seat 4: 1111101000 (7423 in chips) 
Seat 5: wemax (2968 in chips) 
Seat 8: ollikahn23 (2733 in chips) 
Seat 9: 1JORSON (2994 in chips) 
eqmegz: posts the ante 6
MalyshauFish: posts the ante 6
Jarod Prete: posts the ante 6
1111101000: posts the ante 6
wemax: posts the ante 6
ollikahn23: posts the ante 6
1JORSON: posts the ante 6
ollikahn23: posts small blind 25
1JORSON: posts big blind 50
*** HOLE CARDS ***
Dealt to ollikahn23 [3c 9h]
eqmegz: raises 75 to 125
MalyshauFish: folds 
Jarod Prete: calls 125
1111101000: folds 
wemax: folds 
ollikahn23: folds 
1JORSON: folds 
*** FLOP *** [4s 7c Ks]
eqmegz: bets 147
Jarod Prete: folds 
Uncalled bet (147) returned to eqmegz
eqmegz collected 367 from pot
*** SUMMARY ***
Total pot 367 | Rake 0 
Board [4s 7c Ks]
Seat 1: eqmegz collected (367)
Seat 2: MalyshauFish folded before Flop (didn't bet)
Seat 3: Jarod Prete folded on the Flop
Seat 4: 1111101000 folded before Flop (didn't bet)
Seat 5: wemax (button) folded before Flop (didn't bet)
Seat 8: ollikahn23 (small blind) folded before Flop
Seat 9: 1JORSON (big blind) folded before Flop



PokerStars Hand #185451623831: Tournament #2282606587, $13.37+$1.63 USD Hold'em No Limit - Level III (25/50) - 2018/04/20 8:25:05 ET
Table '2282606587 6' 9-max Seat #8 is the button
Seat 1: eqmegz (5924 in chips) 
Seat 2: MalyshauFish (5513 in chips) 
Seat 3: Jarod Prete (3975 in chips) 
Seat 4: 1111101000 (7417 in chips) 
Seat 5: wemax (2962 in chips) 
Seat 6: tuvshin777 (3824 in chips) 
Seat 8: ollikahn23 (2702 in chips) 
Seat 9: 1JORSON (2938 in chips) 
eqmegz: posts the ante 6
MalyshauFish: posts the ante 6
Jarod Prete: posts the ante 6
1111101000: posts the ante 6
wemax: posts the ante 6
tuvshin777: posts the ante 6
ollikahn23: posts the ante 6
1JORSON: posts the ante 6
1JORSON: posts small blind 25
eqmegz: posts big blind 50
*** HOLE CARDS ***
Dealt to ollikahn23 [5s Qs]
MalyshauFish: folds 
Jarod Prete: folds 
1111101000: folds 
wemax: folds 
tuvshin777: folds 
ollikahn23: raises 75 to 125
1JORSON: folds 
eqmegz: calls 75
*** FLOP *** [6h 4c 2h]
eqmegz: checks 
ollikahn23: bets 150
eqmegz: folds 
Uncalled bet (150) returned to ollikahn23
ollikahn23 collected 323 from pot
ollikahn23: doesn't show hand 
*** SUMMARY ***
Total pot 323 | Rake 0 
Board [6h 4c 2h]
Seat 1: eqmegz (big blind) folded on the Flop
Seat 2: MalyshauFish folded before Flop (didn't bet)
Seat 3: Jarod Prete folded before Flop (didn't bet)
Seat 4: 1111101000 folded before Flop (didn't bet)
Seat 5: wemax folded before Flop (didn't bet)
Seat 6: tuvshin777 folded before Flop (didn't bet)
Seat 8: ollikahn23 (button) collected (323)
Seat 9: 1JORSON (small blind) folded before Flop



PokerStars Hand #185451646018: Tournament #2282606587, $13.37+$1.63 USD Hold'em No Limit - Level III (25/50) - 2018/04/20 8:25:58 ET
Table '2282606587 6' 9-max Seat #9 is the button
Seat 1: eqmegz (5793 in chips) 
Seat 2: MalyshauFish (5507 in chips) 
Seat 3: Jarod Prete (3969 in chips) 
Seat 4: 1111101000 (7411 in chips) 
Seat 5: wemax (2956 in chips) 
Seat 6: tuvshin777 (3818 in chips) 
Seat 7: lin9142 (3000 in chips) 
Seat 8: ollikahn23 (2894 in chips) 
Seat 9: 1JORSON (2907 in chips) 
eqmegz: posts the ante 6
MalyshauFish: posts the ante 6
Jarod Prete: posts the ante 6
1111101000: posts the ante 6
wemax: posts the ante 6
tuvshin777: posts the ante 6
lin9142: posts the ante 6
ollikahn23: posts the ante 6
1JORSON: posts the ante 6
eqmegz: posts small blind 25
MalyshauFish: posts big blind 50
*** HOLE CARDS ***
Dealt to ollikahn23 [7s 5h]
Jarod Prete: folds 
1111101000: folds 
wemax: folds 
tuvshin777: calls 50
lin9142: folds 
ollikahn23: folds 
1JORSON: folds 
eqmegz: folds 
MalyshauFish: raises 100 to 150
tuvshin777: calls 100
*** FLOP *** [Ac 8s 4d]
MalyshauFish: bets 190
tuvshin777: raises 190 to 380
MalyshauFish: folds 
Uncalled bet (190) returned to tuvshin777
tuvshin777 collected 759 from pot
tuvshin777: doesn't show hand 
*** SUMMARY ***
Total pot 759 | Rake 0 
Board [Ac 8s 4d]
Seat 1: eqmegz (small blind) folded before Flop
Seat 2: MalyshauFish (big blind) folded on the Flop
Seat 3: Jarod Prete folded before Flop (didn't bet)
Seat 4: 1111101000 folded before Flop (didn't bet)
Seat 5: wemax folded before Flop (didn't bet)
Seat 6: tuvshin777 collected (759)
Seat 7: lin9142 folded before Flop (didn't bet)
Seat 8: ollikahn23 folded before Flop (didn't bet)
Seat 9: 1JORSON (button) folded before Flop (didn't bet)



PokerStars Hand #185451667535: Tournament #2282606587, $13.37+$1.63 USD Hold'em No Limit - Level III (25/50) - 2018/04/20 8:26:50 ET
Table '2282606587 6' 9-max Seat #1 is the button
Seat 1: eqmegz (5762 in chips) 
Seat 2: MalyshauFish (5161 in chips) 
Seat 3: Jarod Prete (3963 in chips) 
Seat 4: 1111101000 (7405 in chips) 
Seat 5: wemax (2950 in chips) 
Seat 6: tuvshin777 (4231 in chips) 
Seat 7: lin9142 (2994 in chips) 
Seat 8: ollikahn23 (2888 in chips) 
Seat 9: 1JORSON (2901 in chips) 
eqmegz: posts the ante 6
MalyshauFish: posts the ante 6
Jarod Prete: posts the ante 6
1111101000: posts the ante 6
wemax: posts the ante 6
tuvshin777: posts the ante 6
lin9142: posts the ante 6
ollikahn23: posts the ante 6
1JORSON: posts the ante 6
MalyshauFish: posts small blind 25
Jarod Prete: posts big blind 50
*** HOLE CARDS ***
Dealt to ollikahn23 [9h 6h]
1111101000: folds 
wemax: folds 
tuvshin777: folds 
lin9142: raises 100 to 150
ollikahn23: folds 
1JORSON: folds 
eqmegz: folds 
MalyshauFish: folds 
Jarod Prete: folds 
Uncalled bet (100) returned to lin9142
lin9142 collected 179 from pot
lin9142: doesn't show hand 
*** SUMMARY ***
Total pot 179 | Rake 0 
Seat 1: eqmegz (button) folded before Flop (didn't bet)
Seat 2: MalyshauFish (small blind) folded before Flop
Seat 3: Jarod Prete (big blind) folded before Flop
Seat 4: 1111101000 folded before Flop (didn't bet)
Seat 5: wemax folded before Flop (didn't bet)
Seat 6: tuvshin777 folded before Flop (didn't bet)
Seat 7: lin9142 collected (179)
Seat 8: ollikahn23 folded before Flop (didn't bet)
Seat 9: 1JORSON folded before Flop (didn't bet)



PokerStars Hand #185451685803: Tournament #2282606587, $13.37+$1.63 USD Hold'em No Limit - Level III (25/50) - 2018/04/20 8:27:34 ET
Table '2282606587 6' 9-max Seat #2 is the button
Seat 1: eqmegz (5756 in chips) 
Seat 2: MalyshauFish (5130 in chips) 
Seat 3: Jarod Prete (3907 in chips) 
Seat 4: 1111101000 (7399 in chips) 
Seat 5: wemax (2944 in chips) 
Seat 6: tuvshin777 (4225 in chips) 
Seat 7: lin9142 (3117 in chips) 
Seat 8: ollikahn23 (2882 in chips) 
Seat 9: 1JORSON (2895 in chips) 
eqmegz: posts the ante 6
MalyshauFish: posts the ante 6
Jarod Prete: posts the ante 6
1111101000: posts the ante 6
wemax: posts the ante 6
tuvshin777: posts the ante 6
lin9142: posts the ante 6
ollikahn23: posts the ante 6
1JORSON: posts the ante 6
Jarod Prete: posts small blind 25
1111101000: posts big blind 50
*** HOLE CARDS ***
Dealt to ollikahn23 [7s 6c]
wemax: folds 
tuvshin777: folds 
lin9142: folds 
ollikahn23: folds 
1JORSON: folds 
eqmegz: folds 
MalyshauFish: raises 75 to 125
Jarod Prete: folds 
1111101000: folds 
Uncalled bet (75) returned to MalyshauFish
MalyshauFish collected 179 from pot
MalyshauFish: doesn't show hand 
*** SUMMARY ***
Total pot 179 | Rake 0 
Seat 1: eqmegz folded before Flop (didn't bet)
Seat 2: MalyshauFish (button) collected (179)
Seat 3: Jarod Prete (small blind) folded before Flop
Seat 4: 1111101000 (big blind) folded before Flop
Seat 5: wemax folded before Flop (didn't bet)
Seat 6: tuvshin777 folded before Flop (didn't bet)
Seat 7: lin9142 folded before Flop (didn't bet)
Seat 8: ollikahn23 folded before Flop (didn't bet)
Seat 9: 1JORSON folded before Flop (didn't bet)



PokerStars Hand #185451702678: Tournament #2282606587, $13.37+$1.63 USD Hold'em No Limit - Level III (25/50) - 2018/04/20 8:28:14 ET
Table '2282606587 6' 9-max Seat #3 is the button
Seat 1: eqmegz (5750 in chips) 
Seat 2: MalyshauFish (5253 in chips) 
Seat 3: Jarod Prete (3876 in chips) 
Seat 4: 1111101000 (7343 in chips) 
Seat 5: wemax (2938 in chips) 
Seat 6: tuvshin777 (4219 in chips) 
Seat 7: lin9142 (3111 in chips) 
Seat 8: ollikahn23 (2876 in chips) 
Seat 9: 1JORSON (2889 in chips) 
eqmegz: posts the ante 6
MalyshauFish: posts the ante 6
Jarod Prete: posts the ante 6
1111101000: posts the ante 6
wemax: posts the ante 6
tuvshin777: posts the ante 6
lin9142: posts the ante 6
ollikahn23: posts the ante 6
1JORSON: posts the ante 6
1111101000: posts small blind 25
wemax: posts big blind 50
*** HOLE CARDS ***
Dealt to ollikahn23 [3h 4d]
tuvshin777: folds 
lin9142: folds 
ollikahn23: folds 
1JORSON: folds 
eqmegz: folds 
MalyshauFish: folds 
Jarod Prete: raises 85 to 135
1111101000: calls 110
wemax: calls 85
*** FLOP *** [2s 6c Tc]
1111101000: checks 
wemax: checks 
Jarod Prete: bets 260
1111101000: folds 
wemax: raises 540 to 800
Jarod Prete: folds 
Uncalled bet (540) returned to wemax
wemax collected 979 from pot
wemax: doesn't show hand 
*** SUMMARY ***
Total pot 979 | Rake 0 
Board [2s 6c Tc]
Seat 1: eqmegz folded before Flop (didn't bet)
Seat 2: MalyshauFish folded before Flop (didn't bet)
Seat 3: Jarod Prete (button) folded on the Flop
Seat 4: 1111101000 (small blind) folded on the Flop
Seat 5: wemax (big blind) collected (979)
Seat 6: tuvshin777 folded before Flop (didn't bet)
Seat 7: lin9142 folded before Flop (didn't bet)
Seat 8: ollikahn23 folded before Flop (didn't bet)
Seat 9: 1JORSON folded before Flop (didn't bet)



PokerStars Hand #185451734148: Tournament #2282606587, $13.37+$1.63 USD Hold'em No Limit - Level III (25/50) - 2018/04/20 8:29:29 ET
Table '2282606587 6' 9-max Seat #4 is the button
Seat 1: eqmegz (5744 in chips) 
Seat 2: MalyshauFish (5247 in chips) 
Seat 3: Jarod Prete (3475 in chips) 
Seat 4: 1111101000 (7202 in chips) 
Seat 5: wemax (3516 in chips) 
Seat 6: tuvshin777 (4213 in chips) 
Seat 7: lin9142 (3105 in chips) 
Seat 8: ollikahn23 (2870 in chips) 
Seat 9: 1JORSON (2883 in chips) 
eqmegz: posts the ante 6
MalyshauFish: posts the ante 6
Jarod Prete: posts the ante 6
1111101000: posts the ante 6
wemax: posts the ante 6
tuvshin777: posts the ante 6
lin9142: posts the ante 6
ollikahn23: posts the ante 6
1JORSON: posts the ante 6
wemax: posts small blind 25
tuvshin777: posts big blind 50
*** HOLE CARDS ***
Dealt to ollikahn23 [Tc 7c]
lin9142: folds 
ollikahn23: folds 
1JORSON: folds 
eqmegz: folds 
MalyshauFish: raises 50 to 100
Jarod Prete: folds 
1111101000: calls 100
wemax: folds 
tuvshin777: calls 50
*** FLOP *** [4h 6h 4s]
tuvshin777: checks 
MalyshauFish: checks 
1111101000: bets 171
tuvshin777: calls 171
MalyshauFish: calls 171
*** TURN *** [4h 6h 4s] [3d]
tuvshin777: checks 
MalyshauFish: checks 
1111101000: checks 
*** RIVER *** [4h 6h 4s 3d] [9d]
tuvshin777: bets 150
MalyshauFish: folds 
1111101000: folds 
Uncalled bet (150) returned to tuvshin777
tuvshin777 collected 892 from pot
tuvshin777: doesn't show hand 
*** SUMMARY ***
Total pot 892 | Rake 0 
Board [4h 6h 4s 3d 9d]
Seat 1: eqmegz folded before Flop (didn't bet)
Seat 2: MalyshauFish folded on the River
Seat 3: Jarod Prete folded before Flop (didn't bet)
Seat 4: 1111101000 (button) folded on the River
Seat 5: wemax (small blind) folded before Flop
Seat 6: tuvshin777 (big blind) collected (892)
Seat 7: lin9142 folded before Flop (didn't bet)
Seat 8: ollikahn23 folded before Flop (didn't bet)
Seat 9: 1JORSON folded before Flop (didn't bet)



PokerStars Hand #185451758349: Tournament #2282606587, $13.37+$1.63 USD Hold'em No Limit - Level III (25/50) - 2018/04/20 8:30:27 ET
Table '2282606587 6' 9-max Seat #5 is the button
Seat 1: eqmegz (5738 in chips) 
Seat 2: MalyshauFish (4970 in chips) 
Seat 3: Jarod Prete (3469 in chips) 
Seat 4: 1111101000 (6925 in chips) 
Seat 5: wemax (3485 in chips) 
Seat 6: tuvshin777 (4828 in chips) 
Seat 7: lin9142 (3099 in chips) 
Seat 8: ollikahn23 (2864 in chips) 
Seat 9: 1JORSON (2877 in chips) 
eqmegz: posts the ante 6
MalyshauFish: posts the ante 6
Jarod Prete: posts the ante 6
1111101000: posts the ante 6
wemax: posts the ante 6
tuvshin777: posts the ante 6
lin9142: posts the ante 6
ollikahn23: posts the ante 6
1JORSON: posts the ante 6
tuvshin777: posts small blind 25
lin9142: posts big blind 50
*** HOLE CARDS ***
Dealt to ollikahn23 [4h 5d]
ollikahn23: folds 
1JORSON: folds 
eqmegz: raises 75 to 125
MalyshauFish: folds 
Jarod Prete: folds 
1111101000: folds 
wemax: folds 
tuvshin777: folds 
lin9142: folds 
Uncalled bet (75) returned to eqmegz
eqmegz collected 179 from pot
*** SUMMARY ***
Total pot 179 | Rake 0 
Seat 1: eqmegz collected (179)
Seat 2: MalyshauFish folded before Flop (didn't bet)
Seat 3: Jarod Prete folded before Flop (didn't bet)
Seat 4: 1111101000 folded before Flop (didn't bet)
Seat 5: wemax (button) folded before Flop (didn't bet)
Seat 6: tuvshin777 (small blind) folded before Flop
Seat 7: lin9142 (big blind) folded before Flop
Seat 8: ollikahn23 folded before Flop (didn't bet)
Seat 9: 1JORSON folded before Flop (didn't bet)



PokerStars Hand #185451767449: Tournament #2282606587, $13.37+$1.63 USD Hold'em No Limit - Level III (25/50) - 2018/04/20 8:30:48 ET
Table '2282606587 6' 9-max Seat #6 is the button
Seat 1: eqmegz (5861 in chips) 
Seat 2: MalyshauFish (4964 in chips) 
Seat 3: Jarod Prete (3463 in chips) 
Seat 4: 1111101000 (6919 in chips) 
Seat 5: wemax (3479 in chips) 
Seat 6: tuvshin777 (4797 in chips) 
Seat 7: lin9142 (3043 in chips) 
Seat 8: ollikahn23 (2858 in chips) 
Seat 9: 1JORSON (2871 in chips) 
eqmegz: posts the ante 6
MalyshauFish: posts the ante 6
Jarod Prete: posts the ante 6
1111101000: posts the ante 6
wemax: posts the ante 6
tuvshin777: posts the ante 6
lin9142: posts the ante 6
ollikahn23: posts the ante 6
1JORSON: posts the ante 6
lin9142: posts small blind 25
ollikahn23: posts big blind 50
*** HOLE CARDS ***
Dealt to ollikahn23 [7h 3s]
1JORSON: folds 
eqmegz: folds 
MalyshauFish: folds 
Jarod Prete: folds 
1111101000: raises 63 to 113
wemax: folds 
tuvshin777: raises 237 to 350
lin9142: folds 
ollikahn23: folds 
1111101000: calls 237
*** FLOP *** [2h Qd Qs]
1111101000: checks 
tuvshin777: checks 
*** TURN *** [2h Qd Qs] [Qh]
1111101000: bets 564
tuvshin777: calls 564
*** RIVER *** [2h Qd Qs Qh] [Th]
1111101000: checks 
tuvshin777: checks 
*** SHOW DOWN ***
1111101000: shows [5c 5s] (a full house, Queens full of Fives)
tuvshin777: mucks hand 
1111101000 collected 1957 from pot
*** SUMMARY ***
Total pot 1957 | Rake 0 
Board [2h Qd Qs Qh Th]
Seat 1: eqmegz folded before Flop (didn't bet)
Seat 2: MalyshauFish folded before Flop (didn't bet)
Seat 3: Jarod Prete folded before Flop (didn't bet)
Seat 4: 1111101000 showed [5c 5s] and won (1957) with a full house, Queens full of Fives
Seat 5: wemax folded before Flop (didn't bet)
Seat 6: tuvshin777 (button) mucked [Ks Ah]
Seat 7: lin9142 (small blind) folded before Flop
Seat 8: ollikahn23 (big blind) folded before Flop
Seat 9: 1JORSON folded before Flop (didn't bet)



PokerStars Hand #185451782498: Tournament #2282606587, $13.37+$1.63 USD Hold'em No Limit - Level III (25/50) - 2018/04/20 8:31:24 ET
Table '2282606587 6' 9-max Seat #7 is the button
Seat 1: eqmegz (5855 in chips) 
Seat 2: MalyshauFish (4958 in chips) 
Seat 3: Jarod Prete (3457 in chips) 
Seat 4: 1111101000 (7956 in chips) 
Seat 5: wemax (3473 in chips) 
Seat 6: tuvshin777 (3877 in chips) 
Seat 7: lin9142 (3012 in chips) 
Seat 8: ollikahn23 (2802 in chips) 
Seat 9: 1JORSON (2865 in chips) 
eqmegz: posts the ante 6
MalyshauFish: posts the ante 6
Jarod Prete: posts the ante 6
1111101000: posts the ante 6
wemax: posts the ante 6
tuvshin777: posts the ante 6
lin9142: posts the ante 6
ollikahn23: posts the ante 6
1JORSON: posts the ante 6
ollikahn23: posts small blind 25
1JORSON: posts big blind 50
*** HOLE CARDS ***
Dealt to ollikahn23 [Ks 4d]
eqmegz: folds 
MalyshauFish: raises 50 to 100
Jarod Prete: folds 
1111101000: raises 150 to 250
wemax: calls 250
tuvshin777: calls 250
lin9142: folds 
ollikahn23: folds 
1JORSON: folds 
MalyshauFish: calls 150
*** FLOP *** [3h 7h 7d]
MalyshauFish: checks 
1111101000: bets 508
wemax: calls 508
tuvshin777: folds 
MalyshauFish: calls 508
*** TURN *** [3h 7h 7d] [6h]
MalyshauFish: checks 
1111101000: checks 
wemax: bets 2709 and is all-in
MalyshauFish: folds 
1111101000: folds 
Uncalled bet (2709) returned to wemax
wemax collected 2653 from pot
wemax: doesn't show hand 
*** SUMMARY ***
Total pot 2653 | Rake 0 
Board [3h 7h 7d 6h]
Seat 1: eqmegz folded before Flop (didn't bet)
Seat 2: MalyshauFish folded on the Turn
Seat 3: Jarod Prete folded before Flop (didn't bet)
Seat 4: 1111101000 folded on the Turn
Seat 5: wemax collected (2653)
Seat 6: tuvshin777 folded on the Flop
Seat 7: lin9142 (button) folded before Flop (didn't bet)
Seat 8: ollikahn23 (small blind) folded before Flop
Seat 9: 1JORSON (big blind) folded before Flop



PokerStars Hand #185451824863: Tournament #2282606587, $13.37+$1.63 USD Hold'em No Limit - Level IV (30/60) - 2018/04/20 8:33:05 ET
Table '2282606587 6' 9-max Seat #8 is the button
Seat 1: eqmegz (5849 in chips) 
Seat 2: MalyshauFish (4194 in chips) 
Seat 3: Jarod Prete (3451 in chips) 
Seat 4: 1111101000 (7192 in chips) 
Seat 5: wemax (5362 in chips) 
Seat 6: tuvshin777 (3621 in chips) 
Seat 7: lin9142 (3006 in chips) 
Seat 8: ollikahn23 (2771 in chips) 
Seat 9: 1JORSON (2809 in chips) 
eqmegz: posts the ante 7
MalyshauFish: posts the ante 7
Jarod Prete: posts the ante 7
1111101000: posts the ante 7
wemax: posts the ante 7
tuvshin777: posts the ante 7
lin9142: posts the ante 7
ollikahn23: posts the ante 7
1JORSON: posts the ante 7
1JORSON: posts small blind 30
eqmegz: posts big blind 60
*** HOLE CARDS ***
Dealt to ollikahn23 [Kh 2d]
MalyshauFish: folds 
Jarod Prete: folds 
1111101000: folds 
wemax: folds 
tuvshin777: folds 
lin9142: folds 
ollikahn23: raises 65 to 125
1JORSON: folds 
eqmegz: calls 65
*** FLOP *** [8c Js 5h]
eqmegz: checks 
ollikahn23: bets 135
eqmegz: raises 208 to 343
ollikahn23: raises 245 to 588
eqmegz: calls 245
*** TURN *** [8c Js 5h] [6s]
eqmegz: checks 
ollikahn23: checks 
*** RIVER *** [8c Js 5h 6s] [Ad]
eqmegz: checks 
ollikahn23: bets 987
eqmegz: folds 
Uncalled bet (987) returned to ollikahn23
ollikahn23 collected 1519 from pot
ollikahn23: doesn't show hand 
*** SUMMARY ***
Total pot 1519 | Rake 0 
Board [8c Js 5h 6s Ad]
Seat 1: eqmegz (big blind) folded on the River
Seat 2: MalyshauFish folded before Flop (didn't bet)
Seat 3: Jarod Prete folded before Flop (didn't bet)
Seat 4: 1111101000 folded before Flop (didn't bet)
Seat 5: wemax folded before Flop (didn't bet)
Seat 6: tuvshin777 folded before Flop (didn't bet)
Seat 7: lin9142 folded before Flop (didn't bet)
Seat 8: ollikahn23 (button) collected (1519)
Seat 9: 1JORSON (small blind) folded before Flop



PokerStars Hand #185451856352: Tournament #2282606587, $13.37+$1.63 USD Hold'em No Limit - Level IV (30/60) - 2018/04/20 8:34:19 ET
Table '2282606587 6' 9-max Seat #9 is the button
Seat 1: eqmegz (5129 in chips) 
Seat 2: MalyshauFish (4187 in chips) 
Seat 3: Jarod Prete (3444 in chips) 
Seat 4: 1111101000 (7185 in chips) 
Seat 5: wemax (5355 in chips) 
Seat 6: tuvshin777 (3614 in chips) 
Seat 7: lin9142 (2999 in chips) 
Seat 8: ollikahn23 (3570 in chips) 
Seat 9: 1JORSON (2772 in chips) 
eqmegz: posts the ante 7
MalyshauFish: posts the ante 7
Jarod Prete: posts the ante 7
1111101000: posts the ante 7
wemax: posts the ante 7
tuvshin777: posts the ante 7
lin9142: posts the ante 7
ollikahn23: posts the ante 7
1JORSON: posts the ante 7
eqmegz: posts small blind 30
MalyshauFish: posts big blind 60
*** HOLE CARDS ***
Dealt to ollikahn23 [Jc 7s]
Jarod Prete: folds 
1111101000: raises 75 to 135
wemax: folds 
tuvshin777: calls 135
lin9142: folds 
ollikahn23: folds 
1JORSON: folds 
eqmegz: folds 
MalyshauFish: calls 75
*** FLOP *** [8s Qd Ah]
MalyshauFish: checks 
1111101000: bets 339
tuvshin777: folds 
MalyshauFish: folds 
Uncalled bet (339) returned to 1111101000
1111101000 collected 498 from pot
1111101000: doesn't show hand 
*** SUMMARY ***
Total pot 498 | Rake 0 
Board [8s Qd Ah]
Seat 1: eqmegz (small blind) folded before Flop
Seat 2: MalyshauFish (big blind) folded on the Flop
Seat 3: Jarod Prete folded before Flop (didn't bet)
Seat 4: 1111101000 collected (498)
Seat 5: wemax folded before Flop (didn't bet)
Seat 6: tuvshin777 folded on the Flop
Seat 7: lin9142 folded before Flop (didn't bet)
Seat 8: ollikahn23 folded before Flop (didn't bet)
Seat 9: 1JORSON (button) folded before Flop (didn't bet)



PokerStars Hand #185451871107: Tournament #2282606587, $13.37+$1.63 USD Hold'em No Limit - Level IV (30/60) - 2018/04/20 8:34:54 ET
Table '2282606587 6' 9-max Seat #1 is the button
Seat 1: eqmegz (5092 in chips) 
Seat 2: MalyshauFish (4045 in chips) 
Seat 3: Jarod Prete (3437 in chips) 
Seat 4: 1111101000 (7541 in chips) 
Seat 5: wemax (5348 in chips) 
Seat 6: tuvshin777 (3472 in chips) 
Seat 7: lin9142 (2992 in chips) 
Seat 8: ollikahn23 (3563 in chips) 
Seat 9: 1JORSON (2765 in chips) 
eqmegz: posts the ante 7
MalyshauFish: posts the ante 7
Jarod Prete: posts the ante 7
1111101000: posts the ante 7
wemax: posts the ante 7
tuvshin777: posts the ante 7
lin9142: posts the ante 7
ollikahn23: posts the ante 7
1JORSON: posts the ante 7
MalyshauFish: posts small blind 30
Jarod Prete: posts big blind 60
*** HOLE CARDS ***
Dealt to ollikahn23 [Jh 3h]
1111101000: folds 
wemax: folds 
tuvshin777: folds 
lin9142: folds 
ollikahn23: folds 
1JORSON: folds 
eqmegz: folds 
MalyshauFish: raises 90 to 150
Jarod Prete: calls 90
*** FLOP *** [7h 3d Qs]
MalyshauFish: bets 182
Jarod Prete: calls 182
*** TURN *** [7h 3d Qs] [Ac]
MalyshauFish: bets 420
Jarod Prete: calls 420
*** RIVER *** [7h 3d Qs Ac] [Kh]
MalyshauFish: checks 
Jarod Prete: checks 
*** SHOW DOWN ***
MalyshauFish: shows [8d Th] (high card Ace)
Jarod Prete: shows [Ts Qd] (a pair of Queens)
Jarod Prete collected 1567 from pot
*** SUMMARY ***
Total pot 1567 | Rake 0 
Board [7h 3d Qs Ac Kh]
Seat 1: eqmegz (button) folded before Flop (didn't bet)
Seat 2: MalyshauFish (small blind) showed [8d Th] and lost with high card Ace
Seat 3: Jarod Prete (big blind) showed [Ts Qd] and won (1567) with a pair of Queens
Seat 4: 1111101000 folded before Flop (didn't bet)
Seat 5: wemax folded before Flop (didn't bet)
Seat 6: tuvshin777 folded before Flop (didn't bet)
Seat 7: lin9142 folded before Flop (didn't bet)
Seat 8: ollikahn23 folded before Flop (didn't bet)
Seat 9: 1JORSON folded before Flop (didn't bet)



PokerStars Hand #185451886587: Tournament #2282606587, $13.37+$1.63 USD Hold'em No Limit - Level IV (30/60) - 2018/04/20 8:35:30 ET
Table '2282606587 6' 9-max Seat #2 is the button
Seat 1: eqmegz (5085 in chips) 
Seat 2: MalyshauFish (3286 in chips) 
Seat 3: Jarod Prete (4245 in chips) 
Seat 4: 1111101000 (7534 in chips) 
Seat 5: wemax (5341 in chips) 
Seat 6: tuvshin777 (3465 in chips) 
Seat 7: lin9142 (2985 in chips) 
Seat 8: ollikahn23 (3556 in chips) 
Seat 9: 1JORSON (2758 in chips) 
eqmegz: posts the ante 7
MalyshauFish: posts the ante 7
Jarod Prete: posts the ante 7
1111101000: posts the ante 7
wemax: posts the ante 7
tuvshin777: posts the ante 7
lin9142: posts the ante 7
ollikahn23: posts the ante 7
1JORSON: posts the ante 7
Jarod Prete: posts small blind 30
1111101000: posts big blind 60
*** HOLE CARDS ***
Dealt to ollikahn23 [3h 6c]
wemax: folds 
tuvshin777: folds 
lin9142: folds 
ollikahn23: folds 
1JORSON: raises 120 to 180
eqmegz: folds 
MalyshauFish: folds 
Jarod Prete: folds 
1111101000: folds 
Uncalled bet (120) returned to 1JORSON
1JORSON collected 213 from pot
1JORSON: doesn't show hand 
*** SUMMARY ***
Total pot 213 | Rake 0 
Seat 1: eqmegz folded before Flop (didn't bet)
Seat 2: MalyshauFish (button) folded before Flop (didn't bet)
Seat 3: Jarod Prete (small blind) folded before Flop
Seat 4: 1111101000 (big blind) folded before Flop
Seat 5: wemax folded before Flop (didn't bet)
Seat 6: tuvshin777 folded before Flop (didn't bet)
Seat 7: lin9142 folded before Flop (didn't bet)
Seat 8: ollikahn23 folded before Flop (didn't bet)
Seat 9: 1JORSON collected (213)



PokerStars Hand #185451910322: Tournament #2282606587, $13.37+$1.63 USD Hold'em No Limit - Level IV (30/60) - 2018/04/20 8:36:27 ET
Table '2282606587 6' 9-max Seat #3 is the button
Seat 1: eqmegz (5078 in chips) 
Seat 2: MalyshauFish (3279 in chips) 
Seat 3: Jarod Prete (4208 in chips) 
Seat 4: 1111101000 (7467 in chips) 
Seat 5: wemax (5334 in chips) 
Seat 6: tuvshin777 (3458 in chips) 
Seat 7: lin9142 (2978 in chips) 
Seat 8: ollikahn23 (3549 in chips) 
Seat 9: 1JORSON (2904 in chips) 
eqmegz: posts the ante 7
MalyshauFish: posts the ante 7
Jarod Prete: posts the ante 7
1111101000: posts the ante 7
wemax: posts the ante 7
tuvshin777: posts the ante 7
lin9142: posts the ante 7
ollikahn23: posts the ante 7
1JORSON: posts the ante 7
1111101000: posts small blind 30
wemax: posts big blind 60
*** HOLE CARDS ***
Dealt to ollikahn23 [9h Th]
tuvshin777: folds 
lin9142: folds 
ollikahn23: raises 65 to 125
1JORSON: folds 
eqmegz: folds 
MalyshauFish: folds 
Jarod Prete: folds 
1111101000: folds 
wemax: calls 65
*** FLOP *** [As 4s 4h]
wemax: checks 
ollikahn23: bets 135
wemax: calls 135
*** TURN *** [As 4s 4h] [Qd]
wemax: checks 
ollikahn23: bets 323
wemax: folds 
Uncalled bet (323) returned to ollikahn23
ollikahn23 collected 613 from pot
ollikahn23: doesn't show hand 
*** SUMMARY ***
Total pot 613 | Rake 0 
Board [As 4s 4h Qd]
Seat 1: eqmegz folded before Flop (didn't bet)
Seat 2: MalyshauFish folded before Flop (didn't bet)
Seat 3: Jarod Prete (button) folded before Flop (didn't bet)
Seat 4: 1111101000 (small blind) folded before Flop
Seat 5: wemax (big blind) folded on the Turn
Seat 6: tuvshin777 folded before Flop (didn't bet)
Seat 7: lin9142 folded before Flop (didn't bet)
Seat 8: ollikahn23 collected (613)
Seat 9: 1JORSON folded before Flop (didn't bet)



PokerStars Hand #185451931705: Tournament #2282606587, $13.37+$1.63 USD Hold'em No Limit - Level IV (30/60) - 2018/04/20 8:37:17 ET
Table '2282606587 6' 9-max Seat #4 is the button
Seat 1: eqmegz (5071 in chips) 
Seat 2: MalyshauFish (3272 in chips) 
Seat 3: Jarod Prete (4201 in chips) 
Seat 4: 1111101000 (7430 in chips) 
Seat 5: wemax (5067 in chips) 
Seat 6: tuvshin777 (3451 in chips) 
Seat 8: ollikahn23 (3895 in chips) 
Seat 9: 1JORSON (2897 in chips) 
eqmegz: posts the ante 7
MalyshauFish: posts the ante 7
Jarod Prete: posts the ante 7
1111101000: posts the ante 7
wemax: posts the ante 7
tuvshin777: posts the ante 7
ollikahn23: posts the ante 7
1JORSON: posts the ante 7
wemax: posts small blind 30
tuvshin777: posts big blind 60
*** HOLE CARDS ***
Dealt to ollikahn23 [Ad 7s]
ollikahn23: folds 
1JORSON: folds 
eqmegz: folds 
MalyshauFish: folds 
Jarod Prete: raises 60 to 120
1111101000: calls 120
wemax: folds 
tuvshin777: folds 
*** FLOP *** [9h 4d Jh]
Jarod Prete: checks 
1111101000: bets 174
Jarod Prete: folds 
Uncalled bet (174) returned to 1111101000
1111101000 collected 386 from pot
1111101000: doesn't show hand 
*** SUMMARY ***
Total pot 386 | Rake 0 
Board [9h 4d Jh]
Seat 1: eqmegz folded before Flop (didn't bet)
Seat 2: MalyshauFish folded before Flop (didn't bet)
Seat 3: Jarod Prete folded on the Flop
Seat 4: 1111101000 (button) collected (386)
Seat 5: wemax (small blind) folded before Flop
Seat 6: tuvshin777 (big blind) folded before Flop
Seat 8: ollikahn23 folded before Flop (didn't bet)
Seat 9: 1JORSON folded before Flop (didn't bet)



PokerStars Hand #185451944829: Tournament #2282606587, $13.37+$1.63 USD Hold'em No Limit - Level IV (30/60) - 2018/04/20 8:37:49 ET
Table '2282606587 6' 9-max Seat #5 is the button
Seat 1: eqmegz (5064 in chips) 
Seat 2: MalyshauFish (3265 in chips) 
Seat 3: Jarod Prete (4074 in chips) 
Seat 4: 1111101000 (7689 in chips) 
Seat 5: wemax (5030 in chips) 
Seat 6: tuvshin777 (3384 in chips) 
Seat 8: ollikahn23 (3888 in chips) 
Seat 9: 1JORSON (2890 in chips) 
eqmegz: posts the ante 7
MalyshauFish: posts the ante 7
Jarod Prete: posts the ante 7
1111101000: posts the ante 7
wemax: posts the ante 7
tuvshin777: posts the ante 7
ollikahn23: posts the ante 7
1JORSON: posts the ante 7
tuvshin777: posts small blind 30
ollikahn23: posts big blind 60
*** HOLE CARDS ***
Dealt to ollikahn23 [Kc Js]
1JORSON: folds 
eqmegz: folds 
MalyshauFish: folds 
Jarod Prete: raises 120 to 180
1111101000: calls 180
wemax: folds 
tuvshin777: folds 
ollikahn23: folds 
*** FLOP *** [6c 7s 4c]
Jarod Prete: checks 
1111101000: bets 228
Jarod Prete: calls 228
*** TURN *** [6c 7s 4c] [Qh]
Jarod Prete: checks 
1111101000: checks 
*** RIVER *** [6c 7s 4c Qh] [Kd]
Jarod Prete: bets 600
1111101000: folds 
Uncalled bet (600) returned to Jarod Prete
Jarod Prete collected 962 from pot
Jarod Prete: doesn't show hand 
*** SUMMARY ***
Total pot 962 | Rake 0 
Board [6c 7s 4c Qh Kd]
Seat 1: eqmegz folded before Flop (didn't bet)
Seat 2: MalyshauFish folded before Flop (didn't bet)
Seat 3: Jarod Prete collected (962)
Seat 4: 1111101000 folded on the River
Seat 5: wemax (button) folded before Flop (didn't bet)
Seat 6: tuvshin777 (small blind) folded before Flop
Seat 8: ollikahn23 (big blind) folded before Flop
Seat 9: 1JORSON folded before Flop (didn't bet)



PokerStars Hand #185451970263: Tournament #2282606587, $13.37+$1.63 USD Hold'em No Limit - Level IV (30/60) - 2018/04/20 8:38:49 ET
Table '2282606587 6' 9-max Seat #6 is the button
Seat 1: eqmegz (5057 in chips) 
Seat 2: MalyshauFish (3258 in chips) 
Seat 3: Jarod Prete (4621 in chips) 
Seat 4: 1111101000 (7274 in chips) 
Seat 5: wemax (5023 in chips) 
Seat 6: tuvshin777 (3347 in chips) 
Seat 8: ollikahn23 (3821 in chips) 
Seat 9: 1JORSON (2883 in chips) 
eqmegz: posts the ante 7
MalyshauFish: posts the ante 7
Jarod Prete: posts the ante 7
1111101000: posts the ante 7
wemax: posts the ante 7
tuvshin777: posts the ante 7
ollikahn23: posts the ante 7
1JORSON: posts the ante 7
ollikahn23: posts small blind 30
1JORSON: posts big blind 60
*** HOLE CARDS ***
Dealt to ollikahn23 [Td Ac]
eqmegz: raises 90 to 150
MalyshauFish: folds 
Jarod Prete: folds 
1111101000: folds 
wemax: folds 
tuvshin777: folds 
ollikahn23: calls 120
1JORSON: calls 90
*** FLOP *** [Kd Ad Qs]
ollikahn23: checks 
1JORSON: checks 
eqmegz: bets 202
ollikahn23: calls 202
1JORSON: calls 202
*** TURN *** [Kd Ad Qs] [Jd]
ollikahn23: bets 480
1JORSON: calls 480
eqmegz: folds 
*** RIVER *** [Kd Ad Qs Jd] [Qc]
ollikahn23: bets 755
1JORSON: raises 1289 to 2044 and is all-in
ollikahn23: calls 1289
*** SHOW DOWN ***
1JORSON: shows [Tc Qd] (a straight, Ten to Ace)
ollikahn23: shows [Td Ac] (a straight, Ten to Ace)
ollikahn23 collected 3080 from pot
1JORSON collected 3080 from pot
*** SUMMARY ***
Total pot 6160 | Rake 0 
Board [Kd Ad Qs Jd Qc]
Seat 1: eqmegz folded on the Turn
Seat 2: MalyshauFish folded before Flop (didn't bet)
Seat 3: Jarod Prete folded before Flop (didn't bet)
Seat 4: 1111101000 folded before Flop (didn't bet)
Seat 5: wemax folded before Flop (didn't bet)
Seat 6: tuvshin777 (button) folded before Flop (didn't bet)
Seat 8: ollikahn23 (small blind) showed [Td Ac] and won (3080) with a straight, Ten to Ace
Seat 9: 1JORSON (big blind) showed [Tc Qd] and won (3080) with a straight, Ten to Ace



PokerStars Hand #185452014134: Tournament #2282606587, $13.37+$1.63 USD Hold'em No Limit - Level IV (30/60) - 2018/04/20 8:40:31 ET
Table '2282606587 6' 9-max Seat #8 is the button
Seat 1: eqmegz (4698 in chips) 
Seat 2: MalyshauFish (3251 in chips) 
Seat 3: Jarod Prete (4614 in chips) 
Seat 4: 1111101000 (7267 in chips) 
Seat 5: wemax (5016 in chips) 
Seat 6: tuvshin777 (3340 in chips) 
Seat 8: ollikahn23 (4018 in chips) 
Seat 9: 1JORSON (3080 in chips) 
eqmegz: posts the ante 7
MalyshauFish: posts the ante 7
Jarod Prete: posts the ante 7
1111101000: posts the ante 7
wemax: posts the ante 7
tuvshin777: posts the ante 7
ollikahn23: posts the ante 7
1JORSON: posts the ante 7
1JORSON: posts small blind 30
eqmegz: posts big blind 60
*** HOLE CARDS ***
Dealt to ollikahn23 [As 4c]
MalyshauFish: raises 60 to 120
Jarod Prete: folds 
1111101000: folds 
wemax: folds 
tuvshin777: folds 
ollikahn23: folds 
1JORSON: folds 
eqmegz: calls 60
*** FLOP *** [3d 6d 5c]
eqmegz: checks 
MalyshauFish: checks 
*** TURN *** [3d 6d 5c] [6s]
eqmegz: checks 
MalyshauFish: bets 163
eqmegz: calls 163
*** RIVER *** [3d 6d 5c 6s] [2h]
eqmegz: checks 
MalyshauFish: bets 435
eqmegz: folds 
Uncalled bet (435) returned to MalyshauFish
MalyshauFish collected 652 from pot
MalyshauFish: doesn't show hand 
*** SUMMARY ***
Total pot 652 | Rake 0 
Board [3d 6d 5c 6s 2h]
Seat 1: eqmegz (big blind) folded on the River
Seat 2: MalyshauFish collected (652)
Seat 3: Jarod Prete folded before Flop (didn't bet)
Seat 4: 1111101000 folded before Flop (didn't bet)
Seat 5: wemax folded before Flop (didn't bet)
Seat 6: tuvshin777 folded before Flop (didn't bet)
Seat 8: ollikahn23 (button) folded before Flop (didn't bet)
Seat 9: 1JORSON (small blind) folded before Flop



PokerStars Hand #185452064950: Tournament #2282606587, $13.37+$1.63 USD Hold'em No Limit - Level V (40/80) - 2018/04/20 8:42:30 ET
Table '2282606587 6' 9-max Seat #9 is the button
Seat 1: eqmegz (4408 in chips) 
Seat 2: MalyshauFish (3613 in chips) 
Seat 3: Jarod Prete (4607 in chips) 
Seat 4: 1111101000 (7260 in chips) 
Seat 5: wemax (5009 in chips) 
Seat 6: tuvshin777 (3333 in chips) 
Seat 8: ollikahn23 (4011 in chips) 
Seat 9: 1JORSON (3043 in chips) 
eqmegz: posts the ante 10
MalyshauFish: posts the ante 10
Jarod Prete: posts the ante 10
1111101000: posts the ante 10
wemax: posts the ante 10
tuvshin777: posts the ante 10
ollikahn23: posts the ante 10
1JORSON: posts the ante 10
eqmegz: posts small blind 40
MalyshauFish: posts big blind 80
*** HOLE CARDS ***
Dealt to ollikahn23 [Ah 9c]
Jarod Prete: raises 105 to 185
1111101000: folds 
wemax: folds 
tuvshin777: folds 
ollikahn23: folds 
1JORSON: folds 
eqmegz: folds 
MalyshauFish: folds 
Uncalled bet (105) returned to Jarod Prete
Jarod Prete collected 280 from pot
Jarod Prete: doesn't show hand 
*** SUMMARY ***
Total pot 280 | Rake 0 
Seat 1: eqmegz (small blind) folded before Flop
Seat 2: MalyshauFish (big blind) folded before Flop
Seat 3: Jarod Prete collected (280)
Seat 4: 1111101000 folded before Flop (didn't bet)
Seat 5: wemax folded before Flop (didn't bet)
Seat 6: tuvshin777 folded before Flop (didn't bet)
Seat 8: ollikahn23 folded before Flop (didn't bet)
Seat 9: 1JORSON (button) folded before Flop (didn't bet)



PokerStars Hand #185452079758: Tournament #2282606587, $13.37+$1.63 USD Hold'em No Limit - Level V (40/80) - 2018/04/20 8:43:04 ET
Table '2282606587 6' 9-max Seat #1 is the button
Seat 1: eqmegz (4358 in chips) 
Seat 2: MalyshauFish (3523 in chips) 
Seat 3: Jarod Prete (4797 in chips) 
Seat 4: 1111101000 (7250 in chips) 
Seat 5: wemax (4999 in chips) 
Seat 6: tuvshin777 (3323 in chips) 
Seat 8: ollikahn23 (4001 in chips) 
Seat 9: 1JORSON (3033 in chips) 
eqmegz: posts the ante 10
MalyshauFish: posts the ante 10
Jarod Prete: posts the ante 10
1111101000: posts the ante 10
wemax: posts the ante 10
tuvshin777: posts the ante 10
ollikahn23: posts the ante 10
1JORSON: posts the ante 10
MalyshauFish: posts small blind 40
Jarod Prete: posts big blind 80
*** HOLE CARDS ***
Dealt to ollikahn23 [Tc 3h]
1111101000: folds 
wemax: folds 
tuvshin777: folds 
ollikahn23: folds 
1JORSON: folds 
eqmegz: folds 
MalyshauFish: raises 120 to 200
Jarod Prete: calls 120
*** FLOP *** [7c 4c 9h]
MalyshauFish: bets 240
Jarod Prete: folds 
Uncalled bet (240) returned to MalyshauFish
MalyshauFish collected 480 from pot
MalyshauFish: doesn't show hand 
*** SUMMARY ***
Total pot 480 | Rake 0 
Board [7c 4c 9h]
Seat 1: eqmegz (button) folded before Flop (didn't bet)
Seat 2: MalyshauFish (small blind) collected (480)
Seat 3: Jarod Prete (big blind) folded on the Flop
Seat 4: 1111101000 folded before Flop (didn't bet)
Seat 5: wemax folded before Flop (didn't bet)
Seat 6: tuvshin777 folded before Flop (didn't bet)
Seat 8: ollikahn23 folded before Flop (didn't bet)
Seat 9: 1JORSON folded before Flop (didn't bet)



PokerStars Hand #185452100132: Tournament #2282606587, $13.37+$1.63 USD Hold'em No Limit - Level V (40/80) - 2018/04/20 8:43:52 ET
Table '2282606587 6' 9-max Seat #2 is the button
Seat 1: eqmegz (4348 in chips) 
Seat 2: MalyshauFish (3793 in chips) 
Seat 3: Jarod Prete (4587 in chips) 
Seat 4: 1111101000 (7240 in chips) 
Seat 5: wemax (4989 in chips) 
Seat 6: tuvshin777 (3313 in chips) 
Seat 7: oliverdan1 (3000 in chips) 
Seat 8: ollikahn23 (3991 in chips) 
Seat 9: 1JORSON (3023 in chips) 
eqmegz: posts the ante 10
MalyshauFish: posts the ante 10
Jarod Prete: posts the ante 10
1111101000: posts the ante 10
wemax: posts the ante 10
tuvshin777: posts the ante 10
oliverdan1: posts the ante 10
ollikahn23: posts the ante 10
1JORSON: posts the ante 10
Jarod Prete: posts small blind 40
1111101000: posts big blind 80
*** HOLE CARDS ***
Dealt to ollikahn23 [Ad 6s]
wemax: folds 
tuvshin777: folds 
oliverdan1: calls 80
ollikahn23: raises 108 to 188
1JORSON: folds 
eqmegz: calls 188
MalyshauFish: calls 188
Jarod Prete: folds 
1111101000: calls 108
oliverdan1: calls 108
*** FLOP *** [Qd 7c 8s]
1111101000: checks 
oliverdan1: bets 240
ollikahn23: folds 
eqmegz: calls 240
MalyshauFish: calls 240
1111101000: calls 240
*** TURN *** [Qd 7c 8s] [4c]
1111101000: checks 
oliverdan1: bets 400
eqmegz: calls 400
MalyshauFish: folds 
1111101000: calls 400
*** RIVER *** [Qd 7c 8s 4c] [Kd]
1111101000: checks 
oliverdan1: checks 
eqmegz: checks 
*** SHOW DOWN ***
1111101000: shows [Jd Th] (high card King)
oliverdan1: shows [Qh 2h] (a pair of Queens)
eqmegz: mucks hand 
oliverdan1 collected 3230 from pot
*** SUMMARY ***
Total pot 3230 | Rake 0 
Board [Qd 7c 8s 4c Kd]
Seat 1: eqmegz mucked [8c 9c]
Seat 2: MalyshauFish (button) folded on the Turn
Seat 3: Jarod Prete (small blind) folded before Flop
Seat 4: 1111101000 (big blind) showed [Jd Th] and lost with high card King
Seat 5: wemax folded before Flop (didn't bet)
Seat 6: tuvshin777 folded before Flop (didn't bet)
Seat 7: oliverdan1 showed [Qh 2h] and won (3230) with a pair of Queens
Seat 8: ollikahn23 folded on the Flop
Seat 9: 1JORSON folded before Flop (didn't bet)



PokerStars Hand #185452140915: Tournament #2282606587, $13.37+$1.63 USD Hold'em No Limit - Level V (40/80) - 2018/04/20 8:45:29 ET
Table '2282606587 6' 9-max Seat #3 is the button
Seat 1: eqmegz (3510 in chips) 
Seat 2: MalyshauFish (3355 in chips) 
Seat 3: Jarod Prete (4537 in chips) 
Seat 4: 1111101000 (6402 in chips) 
Seat 5: wemax (4979 in chips) 
Seat 6: tuvshin777 (3303 in chips) 
Seat 7: oliverdan1 (5392 in chips) 
Seat 8: ollikahn23 (3793 in chips) 
Seat 9: 1JORSON (3013 in chips) 
eqmegz: posts the ante 10
MalyshauFish: posts the ante 10
Jarod Prete: posts the ante 10
1111101000: posts the ante 10
wemax: posts the ante 10
tuvshin777: posts the ante 10
oliverdan1: posts the ante 10
ollikahn23: posts the ante 10
1JORSON: posts the ante 10
1111101000: posts small blind 40
wemax: posts big blind 80
*** HOLE CARDS ***
Dealt to ollikahn23 [2h 5d]
tuvshin777: folds 
oliverdan1: folds 
ollikahn23: folds 
1JORSON: folds 
eqmegz: folds 
MalyshauFish: folds 
Jarod Prete: folds 
1111101000: raises 194 to 274
wemax: folds 
Uncalled bet (194) returned to 1111101000
1111101000 collected 250 from pot
1111101000: doesn't show hand 
*** SUMMARY ***
Total pot 250 | Rake 0 
Seat 1: eqmegz folded before Flop (didn't bet)
Seat 2: MalyshauFish folded before Flop (didn't bet)
Seat 3: Jarod Prete (button) folded before Flop (didn't bet)
Seat 4: 1111101000 (small blind) collected (250)
Seat 5: wemax (big blind) folded before Flop
Seat 6: tuvshin777 folded before Flop (didn't bet)
Seat 7: oliverdan1 folded before Flop (didn't bet)
Seat 8: ollikahn23 folded before Flop (didn't bet)
Seat 9: 1JORSON folded before Flop (didn't bet)



PokerStars Hand #185452152310: Tournament #2282606587, $13.37+$1.63 USD Hold'em No Limit - Level V (40/80) - 2018/04/20 8:45:55 ET
Table '2282606587 6' 9-max Seat #4 is the button
Seat 1: eqmegz (3500 in chips) 
Seat 2: MalyshauFish (3345 in chips) 
Seat 3: Jarod Prete (4527 in chips) 
Seat 4: 1111101000 (6562 in chips) 
Seat 5: wemax (4889 in chips) 
Seat 6: tuvshin777 (3293 in chips) 
Seat 7: oliverdan1 (5382 in chips) 
Seat 8: ollikahn23 (3783 in chips) 
Seat 9: 1JORSON (3003 in chips) 
eqmegz: posts the ante 10
MalyshauFish: posts the ante 10
Jarod Prete: posts the ante 10
1111101000: posts the ante 10
wemax: posts the ante 10
tuvshin777: posts the ante 10
oliverdan1: posts the ante 10
ollikahn23: posts the ante 10
1JORSON: posts the ante 10
wemax: posts small blind 40
tuvshin777: posts big blind 80
*** HOLE CARDS ***
Dealt to ollikahn23 [5h 8s]
oliverdan1: folds 
ollikahn23: folds 
1JORSON: calls 80
eqmegz: folds 
MalyshauFish: raises 160 to 240
Jarod Prete: folds 
1111101000: calls 240
wemax: folds 
tuvshin777: folds 
1JORSON: calls 160
*** FLOP *** [Jc Td 3d]
1JORSON: checks 
MalyshauFish: checks 
1111101000: checks 
*** TURN *** [Jc Td 3d] [9h]
1JORSON: checks 
MalyshauFish: bets 560
1111101000: folds 
1JORSON: calls 560
*** RIVER *** [Jc Td 3d 9h] [7c]
1JORSON: bets 1025
MalyshauFish: folds 
Uncalled bet (1025) returned to 1JORSON
1JORSON collected 2050 from pot
1JORSON: doesn't show hand 
*** SUMMARY ***
Total pot 2050 | Rake 0 
Board [Jc Td 3d 9h 7c]
Seat 1: eqmegz folded before Flop (didn't bet)
Seat 2: MalyshauFish folded on the River
Seat 3: Jarod Prete folded before Flop (didn't bet)
Seat 4: 1111101000 (button) folded on the Turn
Seat 5: wemax (small blind) folded before Flop
Seat 6: tuvshin777 (big blind) folded before Flop
Seat 7: oliverdan1 folded before Flop (didn't bet)
Seat 8: ollikahn23 folded before Flop (didn't bet)
Seat 9: 1JORSON collected (2050)



PokerStars Hand #185452186539: Tournament #2282606587, $13.37+$1.63 USD Hold'em No Limit - Level V (40/80) - 2018/04/20 8:47:15 ET
Table '2282606587 6' 9-max Seat #5 is the button
Seat 1: eqmegz (3490 in chips) 
Seat 2: MalyshauFish (2535 in chips) 
Seat 3: Jarod Prete (4517 in chips) 
Seat 4: 1111101000 (6312 in chips) 
Seat 5: wemax (4839 in chips) 
Seat 6: tuvshin777 (3203 in chips) 
Seat 7: oliverdan1 (5372 in chips) 
Seat 8: ollikahn23 (3773 in chips) 
Seat 9: 1JORSON (4243 in chips) 
eqmegz: posts the ante 10
MalyshauFish: posts the ante 10
Jarod Prete: posts the ante 10
1111101000: posts the ante 10
wemax: posts the ante 10
tuvshin777: posts the ante 10
oliverdan1: posts the ante 10
ollikahn23: posts the ante 10
1JORSON: posts the ante 10
tuvshin777: posts small blind 40
oliverdan1: posts big blind 80
*** HOLE CARDS ***
Dealt to ollikahn23 [6d 8c]
ollikahn23: folds 
1JORSON: calls 80
eqmegz: folds 
MalyshauFish: raises 160 to 240
Jarod Prete: folds 
1111101000: folds 
wemax: folds 
tuvshin777: raises 2953 to 3193 and is all-in
oliverdan1: folds 
1JORSON: folds 
MalyshauFish: folds 
Uncalled bet (2953) returned to tuvshin777
tuvshin777 collected 730 from pot
tuvshin777: doesn't show hand 
*** SUMMARY ***
Total pot 730 | Rake 0 
Seat 1: eqmegz folded before Flop (didn't bet)
Seat 2: MalyshauFish folded before Flop
Seat 3: Jarod Prete folded before Flop (didn't bet)
Seat 4: 1111101000 folded before Flop (didn't bet)
Seat 5: wemax (button) folded before Flop (didn't bet)
Seat 6: tuvshin777 (small blind) collected (730)
Seat 7: oliverdan1 (big blind) folded before Flop
Seat 8: ollikahn23 folded before Flop (didn't bet)
Seat 9: 1JORSON folded before Flop



PokerStars Hand #185452200614: Tournament #2282606587, $13.37+$1.63 USD Hold'em No Limit - Level V (40/80) - 2018/04/20 8:47:48 ET
Table '2282606587 6' 9-max Seat #6 is the button
Seat 1: eqmegz (3480 in chips) 
Seat 2: MalyshauFish (2285 in chips) 
Seat 3: Jarod Prete (4507 in chips) 
Seat 4: 1111101000 (6302 in chips) 
Seat 5: wemax (4829 in chips) 
Seat 6: tuvshin777 (3683 in chips) 
Seat 7: oliverdan1 (5282 in chips) 
Seat 8: ollikahn23 (3763 in chips) 
Seat 9: 1JORSON (4153 in chips) 
eqmegz: posts the ante 10
MalyshauFish: posts the ante 10
Jarod Prete: posts the ante 10
1111101000: posts the ante 10
wemax: posts the ante 10
tuvshin777: posts the ante 10
oliverdan1: posts the ante 10
ollikahn23: posts the ante 10
1JORSON: posts the ante 10
oliverdan1: posts small blind 40
ollikahn23: posts big blind 80
*** HOLE CARDS ***
Dealt to ollikahn23 [Ts Ac]
1JORSON: folds 
eqmegz: folds 
MalyshauFish: folds 
Jarod Prete: folds 
1111101000: raises 100 to 180
wemax: folds 
tuvshin777: calls 180
oliverdan1: calls 140
ollikahn23: calls 100
*** FLOP *** [Qs 4s 2d]
oliverdan1: checks 
ollikahn23: checks 
1111101000: checks 
tuvshin777: checks 
*** TURN *** [Qs 4s 2d] [5s]
oliverdan1: bets 405
ollikahn23: folds 
1111101000: folds 
tuvshin777: folds 
Uncalled bet (405) returned to oliverdan1
oliverdan1 collected 810 from pot
oliverdan1: doesn't show hand 
*** SUMMARY ***
Total pot 810 | Rake 0 
Board [Qs 4s 2d 5s]
Seat 1: eqmegz folded before Flop (didn't bet)
Seat 2: MalyshauFish folded before Flop (didn't bet)
Seat 3: Jarod Prete folded before Flop (didn't bet)
Seat 4: 1111101000 folded on the Turn
Seat 5: wemax folded before Flop (didn't bet)
Seat 6: tuvshin777 (button) folded on the Turn
Seat 7: oliverdan1 (small blind) collected (810)
Seat 8: ollikahn23 (big blind) folded on the Turn
Seat 9: 1JORSON folded before Flop (didn't bet)



PokerStars Hand #185452222854: Tournament #2282606587, $13.37+$1.63 USD Hold'em No Limit - Level V (40/80) - 2018/04/20 8:48:39 ET
Table '2282606587 6' 9-max Seat #7 is the button
Seat 1: eqmegz (3470 in chips) 
Seat 2: MalyshauFish (2275 in chips) 
Seat 3: Jarod Prete (4497 in chips) 
Seat 4: 1111101000 (6112 in chips) 
Seat 5: wemax (4819 in chips) 
Seat 6: tuvshin777 (3493 in chips) 
Seat 7: oliverdan1 (5902 in chips) 
Seat 8: ollikahn23 (3573 in chips) 
Seat 9: 1JORSON (4143 in chips) 
eqmegz: posts the ante 10
MalyshauFish: posts the ante 10
Jarod Prete: posts the ante 10
1111101000: posts the ante 10
wemax: posts the ante 10
tuvshin777: posts the ante 10
oliverdan1: posts the ante 10
ollikahn23: posts the ante 10
1JORSON: posts the ante 10
ollikahn23: posts small blind 40
1JORSON: posts big blind 80
*** HOLE CARDS ***
Dealt to ollikahn23 [2d Ac]
eqmegz: folds 
MalyshauFish: raises 80 to 160
Jarod Prete: folds 
1111101000: folds 
wemax: calls 160
tuvshin777: calls 160
oliverdan1: calls 160
ollikahn23: folds 
1JORSON: calls 80
*** FLOP *** [9c 4c 8d]
1JORSON: checks 
MalyshauFish: bets 620
wemax: folds 
tuvshin777: folds 
oliverdan1: calls 620
1JORSON: folds 
*** TURN *** [9c 4c 8d] [7s]
MalyshauFish: bets 1485 and is all-in
oliverdan1: folds [Kc 3c]
Uncalled bet (1485) returned to MalyshauFish
MalyshauFish collected 2170 from pot
MalyshauFish: doesn't show hand 
*** SUMMARY ***
Total pot 2170 | Rake 0 
Board [9c 4c 8d 7s]
Seat 1: eqmegz folded before Flop (didn't bet)
Seat 2: MalyshauFish collected (2170)
Seat 3: Jarod Prete folded before Flop (didn't bet)
Seat 4: 1111101000 folded before Flop (didn't bet)
Seat 5: wemax folded on the Flop
Seat 6: tuvshin777 folded on the Flop
Seat 7: oliverdan1 (button) folded on the Turn
Seat 8: ollikahn23 (small blind) folded before Flop
Seat 9: 1JORSON (big blind) folded on the Flop



PokerStars Hand #185452249931: Tournament #2282606587, $13.37+$1.63 USD Hold'em No Limit - Level V (40/80) - 2018/04/20 8:49:42 ET
Table '2282606587 6' 9-max Seat #8 is the button
Seat 1: eqmegz (3460 in chips) 
Seat 2: MalyshauFish (3655 in chips) 
Seat 3: Jarod Prete (4487 in chips) 
Seat 4: 1111101000 (6102 in chips) 
Seat 5: wemax (4649 in chips) 
Seat 6: tuvshin777 (3323 in chips) 
Seat 7: oliverdan1 (5112 in chips) 
Seat 8: ollikahn23 (3523 in chips) 
Seat 9: 1JORSON (3973 in chips) 
eqmegz: posts the ante 10
MalyshauFish: posts the ante 10
Jarod Prete: posts the ante 10
1111101000: posts the ante 10
wemax: posts the ante 10
tuvshin777: posts the ante 10
oliverdan1: posts the ante 10
ollikahn23: posts the ante 10
1JORSON: posts the ante 10
1JORSON: posts small blind 40
eqmegz: posts big blind 80
*** HOLE CARDS ***
Dealt to ollikahn23 [Qs 6s]
MalyshauFish: folds 
Jarod Prete: folds 
1111101000: folds 
wemax: folds 
tuvshin777: folds 
oliverdan1: folds 
ollikahn23: raises 85 to 165
1JORSON: calls 125
eqmegz: calls 85
*** FLOP *** [Ts 5c Tc]
1JORSON: checks 
eqmegz: checks 
ollikahn23: bets 345
1JORSON: folds 
eqmegz: folds 
Uncalled bet (345) returned to ollikahn23
ollikahn23 collected 585 from pot
ollikahn23: doesn't show hand 
*** SUMMARY ***
Total pot 585 | Rake 0 
Board [Ts 5c Tc]
Seat 1: eqmegz (big blind) folded on the Flop
Seat 2: MalyshauFish folded before Flop (didn't bet)
Seat 3: Jarod Prete folded before Flop (didn't bet)
Seat 4: 1111101000 folded before Flop (didn't bet)
Seat 5: wemax folded before Flop (didn't bet)
Seat 6: tuvshin777 folded before Flop (didn't bet)
Seat 7: oliverdan1 folded before Flop (didn't bet)
Seat 8: ollikahn23 (button) collected (585)
Seat 9: 1JORSON (small blind) folded on the Flop



PokerStars Hand #185452274720: Tournament #2282606587, $13.37+$1.63 USD Hold'em No Limit - Level V (40/80) - 2018/04/20 8:50:39 ET
Table '2282606587 6' 9-max Seat #9 is the button
Seat 1: eqmegz (3285 in chips) 
Seat 2: MalyshauFish (3645 in chips) 
Seat 3: Jarod Prete (4477 in chips) 
Seat 4: 1111101000 (6092 in chips) 
Seat 5: wemax (4639 in chips) 
Seat 6: tuvshin777 (3313 in chips) 
Seat 7: oliverdan1 (5102 in chips) 
Seat 8: ollikahn23 (3933 in chips) 
Seat 9: 1JORSON (3798 in chips) 
eqmegz: posts the ante 10
MalyshauFish: posts the ante 10
Jarod Prete: posts the ante 10
1111101000: posts the ante 10
wemax: posts the ante 10
tuvshin777: posts the ante 10
oliverdan1: posts the ante 10
ollikahn23: posts the ante 10
1JORSON: posts the ante 10
eqmegz: posts small blind 40
MalyshauFish: posts big blind 80
*** HOLE CARDS ***
Dealt to ollikahn23 [Qd 8h]
Jarod Prete: folds 
1111101000: folds 
wemax: folds 
tuvshin777: folds 
oliverdan1: folds 
ollikahn23: raises 85 to 165
1JORSON: calls 165
eqmegz: folds 
MalyshauFish: calls 85
*** FLOP *** [7c 8s 4c]
MalyshauFish: checks 
ollikahn23: bets 385
1JORSON: calls 385
MalyshauFish: calls 385
*** TURN *** [7c 8s 4c] [Kd]
MalyshauFish: checks 
ollikahn23: checks 
1JORSON: checks 
*** RIVER *** [7c 8s 4c Kd] [Jc]
MalyshauFish: checks 
ollikahn23: checks 
1JORSON: checks 
*** SHOW DOWN ***
MalyshauFish: shows [5h 4d] (a pair of Fours)
ollikahn23: shows [Qd 8h] (a pair of Eights)
1JORSON: mucks hand 
ollikahn23 collected 1780 from pot
*** SUMMARY ***
Total pot 1780 | Rake 0 
Board [7c 8s 4c Kd Jc]
Seat 1: eqmegz (small blind) folded before Flop
Seat 2: MalyshauFish (big blind) showed [5h 4d] and lost with a pair of Fours
Seat 3: Jarod Prete folded before Flop (didn't bet)
Seat 4: 1111101000 folded before Flop (didn't bet)
Seat 5: wemax folded before Flop (didn't bet)
Seat 6: tuvshin777 folded before Flop (didn't bet)
Seat 7: oliverdan1 folded before Flop (didn't bet)
Seat 8: ollikahn23 showed [Qd 8h] and won (1780) with a pair of Eights
Seat 9: 1JORSON (button) mucked [4s 5s]



PokerStars Hand #185452311887: Tournament #2282606587, $13.37+$1.63 USD Hold'em No Limit - Level V (40/80) - 2018/04/20 8:52:05 ET
Table '2282606587 6' 9-max Seat #1 is the button
Seat 1: eqmegz (3235 in chips) 
Seat 2: MalyshauFish (3085 in chips) 
Seat 3: Jarod Prete (4467 in chips) 
Seat 4: 1111101000 (6082 in chips) 
Seat 5: wemax (4629 in chips) 
Seat 6: tuvshin777 (3303 in chips) 
Seat 7: oliverdan1 (5092 in chips) 
Seat 8: ollikahn23 (5153 in chips) 
Seat 9: 1JORSON (3238 in chips) 
eqmegz: posts the ante 10
MalyshauFish: posts the ante 10
Jarod Prete: posts the ante 10
1111101000: posts the ante 10
wemax: posts the ante 10
tuvshin777: posts the ante 10
oliverdan1: posts the ante 10
ollikahn23: posts the ante 10
1JORSON: posts the ante 10
MalyshauFish: posts small blind 40
Jarod Prete: posts big blind 80
*** HOLE CARDS ***
Dealt to ollikahn23 [3c 4c]
1111101000: raises 100 to 180
wemax: folds 
tuvshin777: folds 
oliverdan1: folds 
ollikahn23: folds 
1JORSON: calls 180
eqmegz: calls 180
MalyshauFish: folds 
Jarod Prete: calls 100
*** FLOP *** [7c 5c Jc]
Jarod Prete: checks 
1111101000: checks 
1JORSON: checks 
eqmegz: checks 
*** TURN *** [7c 5c Jc] [3s]
Jarod Prete: bets 80
1111101000: calls 80
1JORSON: calls 80
eqmegz: raises 468 to 548
Jarod Prete: folds 
1111101000: folds 
1JORSON: folds 
Uncalled bet (468) returned to eqmegz
eqmegz collected 1170 from pot
*** SUMMARY ***
Total pot 1170 | Rake 0 
Board [7c 5c Jc 3s]
Seat 1: eqmegz (button) collected (1170)
Seat 2: MalyshauFish (small blind) folded before Flop
Seat 3: Jarod Prete (big blind) folded on the Turn
Seat 4: 1111101000 folded on the Turn
Seat 5: wemax folded before Flop (didn't bet)
Seat 6: tuvshin777 folded before Flop (didn't bet)
Seat 7: oliverdan1 folded before Flop (didn't bet)
Seat 8: ollikahn23 folded before Flop (didn't bet)
Seat 9: 1JORSON folded on the Turn



PokerStars Hand #185452363742: Tournament #2282606587, $13.37+$1.63 USD Hold'em No Limit - Level VI (50/100) - 2018/04/20 8:54:05 ET
Table '2282606587 6' 9-max Seat #2 is the button
Seat 1: eqmegz (4135 in chips) 
Seat 2: MalyshauFish (3035 in chips) 
Seat 3: Jarod Prete (4197 in chips) 
Seat 4: 1111101000 (5812 in chips) 
Seat 5: wemax (4619 in chips) 
Seat 6: tuvshin777 (3293 in chips) 
Seat 7: oliverdan1 (5082 in chips) 
Seat 8: ollikahn23 (5143 in chips) 
Seat 9: 1JORSON (2968 in chips) 
eqmegz: posts the ante 12
MalyshauFish: posts the ante 12
Jarod Prete: posts the ante 12
1111101000: posts the ante 12
wemax: posts the ante 12
tuvshin777: posts the ante 12
oliverdan1: posts the ante 12
ollikahn23: posts the ante 12
1JORSON: posts the ante 12
Jarod Prete: posts small blind 50
1111101000: posts big blind 100
*** HOLE CARDS ***
Dealt to ollikahn23 [2s 8d]
wemax: folds 
tuvshin777: folds 
oliverdan1: raises 100 to 200
ollikahn23: folds 
1JORSON: folds 
eqmegz: folds 
MalyshauFish: folds 
Jarod Prete: folds 
1111101000: calls 100
*** FLOP *** [Ah Ac 3s]
1111101000: checks 
oliverdan1: checks 
*** TURN *** [Ah Ac 3s] [9c]
1111101000: checks 
oliverdan1: bets 200
1111101000: folds 
Uncalled bet (200) returned to oliverdan1
oliverdan1 collected 558 from pot
oliverdan1: doesn't show hand 
*** SUMMARY ***
Total pot 558 | Rake 0 
Board [Ah Ac 3s 9c]
Seat 1: eqmegz folded before Flop (didn't bet)
Seat 2: MalyshauFish (button) folded before Flop (didn't bet)
Seat 3: Jarod Prete (small blind) folded before Flop
Seat 4: 1111101000 (big blind) folded on the Turn
Seat 5: wemax folded before Flop (didn't bet)
Seat 6: tuvshin777 folded before Flop (didn't bet)
Seat 7: oliverdan1 collected (558)
Seat 8: ollikahn23 folded before Flop (didn't bet)
Seat 9: 1JORSON folded before Flop (didn't bet)



PokerStars Hand #185452378804: Tournament #2282606587, $13.37+$1.63 USD Hold'em No Limit - Level VI (50/100) - 2018/04/20 8:54:40 ET
Table '2282606587 6' 9-max Seat #3 is the button
Seat 1: eqmegz (4123 in chips) 
Seat 2: MalyshauFish (3023 in chips) 
Seat 3: Jarod Prete (4135 in chips) 
Seat 4: 1111101000 (5600 in chips) 
Seat 5: wemax (4607 in chips) 
Seat 6: tuvshin777 (3281 in chips) 
Seat 7: oliverdan1 (5428 in chips) 
Seat 8: ollikahn23 (5131 in chips) 
Seat 9: 1JORSON (2956 in chips) 
eqmegz: posts the ante 12
MalyshauFish: posts the ante 12
Jarod Prete: posts the ante 12
1111101000: posts the ante 12
wemax: posts the ante 12
tuvshin777: posts the ante 12
oliverdan1: posts the ante 12
ollikahn23: posts the ante 12
1JORSON: posts the ante 12
1111101000: posts small blind 50
wemax: posts big blind 100
*** HOLE CARDS ***
Dealt to ollikahn23 [Kc 4d]
tuvshin777: folds 
oliverdan1: raises 100 to 200
ollikahn23: folds 
1JORSON: folds 
eqmegz: folds 
MalyshauFish: folds 
Jarod Prete: folds 
1111101000: folds 
wemax: calls 100
*** FLOP *** [2s 8h 2c]
wemax: checks 
oliverdan1: bets 200
wemax: folds 
Uncalled bet (200) returned to oliverdan1
oliverdan1 collected 558 from pot
oliverdan1: doesn't show hand 
*** SUMMARY ***
Total pot 558 | Rake 0 
Board [2s 8h 2c]
Seat 1: eqmegz folded before Flop (didn't bet)
Seat 2: MalyshauFish folded before Flop (didn't bet)
Seat 3: Jarod Prete (button) folded before Flop (didn't bet)
Seat 4: 1111101000 (small blind) folded before Flop
Seat 5: wemax (big blind) folded on the Flop
Seat 6: tuvshin777 folded before Flop (didn't bet)
Seat 7: oliverdan1 collected (558)
Seat 8: ollikahn23 folded before Flop (didn't bet)
Seat 9: 1JORSON folded before Flop (didn't bet)



PokerStars Hand #185452390427: Tournament #2282606587, $13.37+$1.63 USD Hold'em No Limit - Level VI (50/100) - 2018/04/20 8:55:06 ET
Table '2282606587 6' 9-max Seat #4 is the button
Seat 1: eqmegz (4111 in chips) 
Seat 2: MalyshauFish (3011 in chips) 
Seat 3: Jarod Prete (4123 in chips) 
Seat 4: 1111101000 (5538 in chips) 
Seat 5: wemax (4395 in chips) 
Seat 6: tuvshin777 (3269 in chips) 
Seat 7: oliverdan1 (5774 in chips) 
Seat 8: ollikahn23 (5119 in chips) 
Seat 9: 1JORSON (2944 in chips) 
eqmegz: posts the ante 12
MalyshauFish: posts the ante 12
Jarod Prete: posts the ante 12
1111101000: posts the ante 12
wemax: posts the ante 12
tuvshin777: posts the ante 12
oliverdan1: posts the ante 12
ollikahn23: posts the ante 12
1JORSON: posts the ante 12
wemax: posts small blind 50
tuvshin777: posts big blind 100
*** HOLE CARDS ***
Dealt to ollikahn23 [5h 9d]
oliverdan1: raises 200 to 300
ollikahn23: folds 
1JORSON: folds 
eqmegz: folds 
MalyshauFish: folds 
Jarod Prete: folds 
1111101000: calls 300
wemax: folds 
tuvshin777: calls 200
*** FLOP *** [9h 5s 9s]
tuvshin777: checks 
oliverdan1: bets 300
1111101000: raises 500 to 800
tuvshin777: folds 
oliverdan1: calls 500
*** TURN *** [9h 5s 9s] [Ah]
oliverdan1: checks 
1111101000: checks 
*** RIVER *** [9h 5s 9s Ah] [Td]
oliverdan1: bets 1500
1111101000: raises 2926 to 4426 and is all-in
oliverdan1: calls 2926
*** SHOW DOWN ***
1111101000: shows [9c As] (a full house, Nines full of Aces)
oliverdan1: shows [Ac Qc] (two pair, Aces and Nines)
1111101000 collected 11510 from pot
*** SUMMARY ***
Total pot 11510 | Rake 0 
Board [9h 5s 9s Ah Td]
Seat 1: eqmegz folded before Flop (didn't bet)
Seat 2: MalyshauFish folded before Flop (didn't bet)
Seat 3: Jarod Prete folded before Flop (didn't bet)
Seat 4: 1111101000 (button) showed [9c As] and won (11510) with a full house, Nines full of Aces
Seat 5: wemax (small blind) folded before Flop
Seat 6: tuvshin777 (big blind) folded on the Flop
Seat 7: oliverdan1 showed [Ac Qc] and lost with two pair, Aces and Nines
Seat 8: ollikahn23 folded before Flop (didn't bet)
Seat 9: 1JORSON folded before Flop (didn't bet)



PokerStars Hand #185452548615: Tournament #2282606587, $13.37+$1.63 USD Hold'em No Limit - Level VI (50/100) - 2018/04/20 9:01:50 ET
Table '2282606587 6' 9-max Seat #5 is the button
Seat 1: eqmegz (4099 in chips) 
Seat 2: MalyshauFish (2999 in chips) 
Seat 3: Jarod Prete (4111 in chips) 
Seat 4: 1111101000 (11510 in chips) 
Seat 5: wemax (4333 in chips) 
Seat 6: tuvshin777 (2957 in chips) 
Seat 7: oliverdan1 (236 in chips) 
Seat 8: ollikahn23 (5107 in chips) 
Seat 9: 1JORSON (2932 in chips) 
eqmegz: posts the ante 12
MalyshauFish: posts the ante 12
Jarod Prete: posts the ante 12
1111101000: posts the ante 12
wemax: posts the ante 12
tuvshin777: posts the ante 12
oliverdan1: posts the ante 12
ollikahn23: posts the ante 12
1JORSON: posts the ante 12
tuvshin777: posts small blind 50
oliverdan1: posts big blind 100
*** HOLE CARDS ***
Dealt to ollikahn23 [7h Ac]
ollikahn23: folds 
1JORSON: folds 
eqmegz: folds 
MalyshauFish: folds 
Jarod Prete has timed out
Jarod Prete: folds 
Jarod Prete is sitting out
1111101000: folds 
wemax: folds 
tuvshin777: folds 
Uncalled bet (50) returned to oliverdan1
oliverdan1 collected 208 from pot
oliverdan1: doesn't show hand 
*** SUMMARY ***
Total pot 208 | Rake 0 
Seat 1: eqmegz folded before Flop (didn't bet)
Seat 2: MalyshauFish folded before Flop (didn't bet)
Seat 3: Jarod Prete folded before Flop (didn't bet)
Seat 4: 1111101000 folded before Flop (didn't bet)
Seat 5: wemax (button) folded before Flop (didn't bet)
Seat 6: tuvshin777 (small blind) folded before Flop
Seat 7: oliverdan1 (big blind) collected (208)
Seat 8: ollikahn23 folded before Flop (didn't bet)
Seat 9: 1JORSON folded before Flop (didn't bet)



PokerStars Hand #185452583018: Tournament #2282606587, $13.37+$1.63 USD Hold'em No Limit - Level VI (50/100) - 2018/04/20 9:03:10 ET
Table '2282606587 6' 9-max Seat #6 is the button
Seat 1: eqmegz (4087 in chips) 
Seat 2: MalyshauFish (2987 in chips) 
Seat 3: Jarod Prete (4099 in chips) is sitting out
Seat 4: 1111101000 (11498 in chips) 
Seat 5: wemax (4321 in chips) 
Seat 6: tuvshin777 (2895 in chips) 
Seat 7: oliverdan1 (382 in chips) 
Seat 8: ollikahn23 (5095 in chips) 
Seat 9: 1JORSON (2920 in chips) 
eqmegz: posts the ante 12
MalyshauFish: posts the ante 12
Jarod Prete: posts the ante 12
1111101000: posts the ante 12
wemax: posts the ante 12
tuvshin777: posts the ante 12
oliverdan1: posts the ante 12
ollikahn23: posts the ante 12
1JORSON: posts the ante 12
oliverdan1: posts small blind 50
ollikahn23: posts big blind 100
*** HOLE CARDS ***
Dealt to ollikahn23 [Jh 7h]
1JORSON: folds 
eqmegz: folds 
MalyshauFish: folds 
Jarod Prete: folds 
1111101000: folds 
wemax: folds 
tuvshin777: folds 
oliverdan1: raises 270 to 370 and is all-in
Jarod Prete has returned
ollikahn23: calls 270
*** FLOP *** [4c 6s Ks]
*** TURN *** [4c 6s Ks] [9c]
*** RIVER *** [4c 6s Ks 9c] [Qh]
*** SHOW DOWN ***
oliverdan1: shows [Td 4d] (a pair of Fours)
ollikahn23: shows [Jh 7h] (high card King)
oliverdan1 collected 848 from pot
*** SUMMARY ***
Total pot 848 | Rake 0 
Board [4c 6s Ks 9c Qh]
Seat 1: eqmegz folded before Flop (didn't bet)
Seat 2: MalyshauFish folded before Flop (didn't bet)
Seat 3: Jarod Prete folded before Flop (didn't bet)
Seat 4: 1111101000 folded before Flop (didn't bet)
Seat 5: wemax folded before Flop (didn't bet)
Seat 6: tuvshin777 (button) folded before Flop (didn't bet)
Seat 7: oliverdan1 (small blind) showed [Td 4d] and won (848) with a pair of Fours
Seat 8: ollikahn23 (big blind) showed [Jh 7h] and lost with high card King
Seat 9: 1JORSON folded before Flop (didn't bet)



PokerStars Hand #185452596817: Tournament #2282606587, $13.37+$1.63 USD Hold'em No Limit - Level VI (50/100) - 2018/04/20 9:03:41 ET
Table '2282606587 6' 9-max Seat #7 is the button
Seat 1: eqmegz (4075 in chips) 
Seat 2: MalyshauFish (2975 in chips) 
Seat 3: Jarod Prete (4087 in chips) 
Seat 4: 1111101000 (11486 in chips) 
Seat 5: wemax (4309 in chips) 
Seat 6: tuvshin777 (2883 in chips) 
Seat 7: oliverdan1 (848 in chips) 
Seat 8: ollikahn23 (4713 in chips) 
Seat 9: 1JORSON (2908 in chips) 
eqmegz: posts the ante 12
MalyshauFish: posts the ante 12
Jarod Prete: posts the ante 12
1111101000: posts the ante 12
wemax: posts the ante 12
tuvshin777: posts the ante 12
oliverdan1: posts the ante 12
ollikahn23: posts the ante 12
1JORSON: posts the ante 12
ollikahn23: posts small blind 50
1JORSON: posts big blind 100
*** HOLE CARDS ***
Dealt to ollikahn23 [4h Td]
eqmegz: folds 
MalyshauFish: raises 100 to 200
Jarod Prete: folds 
1111101000: folds 
wemax: calls 200
tuvshin777: folds 
oliverdan1: folds 
ollikahn23: folds 
1JORSON: folds 
*** FLOP *** [4s 6c 8c]
MalyshauFish: bets 329
wemax: raises 3768 to 4097 and is all-in
MalyshauFish: folds 
Uncalled bet (3768) returned to wemax
wemax collected 1316 from pot
wemax: doesn't show hand 
*** SUMMARY ***
Total pot 1316 | Rake 0 
Board [4s 6c 8c]
Seat 1: eqmegz folded before Flop (didn't bet)
Seat 2: MalyshauFish folded on the Flop
Seat 3: Jarod Prete folded before Flop (didn't bet)
Seat 4: 1111101000 folded before Flop (didn't bet)
Seat 5: wemax collected (1316)
Seat 6: tuvshin777 folded before Flop (didn't bet)
Seat 7: oliverdan1 (button) folded before Flop (didn't bet)
Seat 8: ollikahn23 (small blind) folded before Flop
Seat 9: 1JORSON (big blind) folded before Flop



PokerStars Hand #185452616322: Tournament #2282606587, $13.37+$1.63 USD Hold'em No Limit - Level VI (50/100) - 2018/04/20 9:04:24 ET
Table '2282606587 6' 9-max Seat #8 is the button
Seat 1: eqmegz (4063 in chips) 
Seat 2: MalyshauFish (2434 in chips) 
Seat 3: Jarod Prete (4075 in chips) 
Seat 4: 1111101000 (11474 in chips) 
Seat 5: wemax (5084 in chips) 
Seat 6: tuvshin777 (2871 in chips) 
Seat 7: oliverdan1 (836 in chips) 
Seat 8: ollikahn23 (4651 in chips) 
Seat 9: 1JORSON (2796 in chips) 
eqmegz: posts the ante 12
MalyshauFish: posts the ante 12
Jarod Prete: posts the ante 12
1111101000: posts the ante 12
wemax: posts the ante 12
tuvshin777: posts the ante 12
oliverdan1: posts the ante 12
ollikahn23: posts the ante 12
1JORSON: posts the ante 12
1JORSON: posts small blind 50
eqmegz: posts big blind 100
*** HOLE CARDS ***
Dealt to ollikahn23 [3h 6c]
MalyshauFish: folds 
Jarod Prete: folds 
1111101000: folds 
wemax: folds 
tuvshin777: folds 
oliverdan1: raises 724 to 824 and is all-in
ollikahn23: folds 
1JORSON: folds 
eqmegz: calls 724
*** FLOP *** [8c 9d 7d]
*** TURN *** [8c 9d 7d] [3c]
*** RIVER *** [8c 9d 7d 3c] [9h]
*** SHOW DOWN ***
eqmegz: shows [Qs Kc] (a pair of Nines)
oliverdan1: shows [Qd Ah] (a pair of Nines - Ace kicker)
oliverdan1 collected 1806 from pot
*** SUMMARY ***
Total pot 1806 | Rake 0 
Board [8c 9d 7d 3c 9h]
Seat 1: eqmegz (big blind) showed [Qs Kc] and lost with a pair of Nines
Seat 2: MalyshauFish folded before Flop (didn't bet)
Seat 3: Jarod Prete folded before Flop (didn't bet)
Seat 4: 1111101000 folded before Flop (didn't bet)
Seat 5: wemax folded before Flop (didn't bet)
Seat 6: tuvshin777 folded before Flop (didn't bet)
Seat 7: oliverdan1 showed [Qd Ah] and won (1806) with a pair of Nines
Seat 8: ollikahn23 (button) folded before Flop (didn't bet)
Seat 9: 1JORSON (small blind) folded before Flop



PokerStars Hand #185452639193: Tournament #2282606587, $13.37+$1.63 USD Hold'em No Limit - Level VI (50/100) - 2018/04/20 9:05:14 ET
Table '2282606587 6' 9-max Seat #9 is the button
Seat 1: eqmegz (3227 in chips) 
Seat 2: MalyshauFish (2422 in chips) 
Seat 3: Jarod Prete (4063 in chips) 
Seat 4: 1111101000 (11462 in chips) 
Seat 5: wemax (5072 in chips) 
Seat 6: tuvshin777 (2859 in chips) 
Seat 7: oliverdan1 (1806 in chips) 
Seat 8: ollikahn23 (4639 in chips) 
Seat 9: 1JORSON (2734 in chips) 
eqmegz: posts the ante 12
MalyshauFish: posts the ante 12
Jarod Prete: posts the ante 12
1111101000: posts the ante 12
wemax: posts the ante 12
tuvshin777: posts the ante 12
oliverdan1: posts the ante 12
ollikahn23: posts the ante 12
1JORSON: posts the ante 12
eqmegz: posts small blind 50
MalyshauFish: posts big blind 100
*** HOLE CARDS ***
Dealt to ollikahn23 [7d 3h]
Jarod Prete: raises 155 to 255
1111101000: folds 
wemax: folds 
tuvshin777: folds 
oliverdan1: folds 
ollikahn23: folds 
1JORSON: folds 
eqmegz: folds 
MalyshauFish: calls 155
*** FLOP *** [8s Jh Kc]
MalyshauFish: checks 
Jarod Prete: checks 
*** TURN *** [8s Jh Kc] [Th]
MalyshauFish: checks 
Jarod Prete: bets 450
MalyshauFish: folds 
Uncalled bet (450) returned to Jarod Prete
Jarod Prete collected 668 from pot
*** SUMMARY ***
Total pot 668 | Rake 0 
Board [8s Jh Kc Th]
Seat 1: eqmegz (small blind) folded before Flop
Seat 2: MalyshauFish (big blind) folded on the Turn
Seat 3: Jarod Prete collected (668)
Seat 4: 1111101000 folded before Flop (didn't bet)
Seat 5: wemax folded before Flop (didn't bet)
Seat 6: tuvshin777 folded before Flop (didn't bet)
Seat 7: oliverdan1 folded before Flop (didn't bet)
Seat 8: ollikahn23 folded before Flop (didn't bet)
Seat 9: 1JORSON (button) folded before Flop (didn't bet)



PokerStars Hand #185452664088: Tournament #2282606587, $13.37+$1.63 USD Hold'em No Limit - Level VI (50/100) - 2018/04/20 9:06:09 ET
Table '2282606587 6' 9-max Seat #1 is the button
Seat 1: eqmegz (3165 in chips) 
Seat 2: MalyshauFish (2155 in chips) 
Seat 4: 1111101000 (11450 in chips) 
Seat 5: wemax (5060 in chips) 
Seat 6: tuvshin777 (2847 in chips) 
Seat 7: oliverdan1 (1794 in chips) 
Seat 8: ollikahn23 (4627 in chips) 
Seat 9: 1JORSON (2722 in chips) 
eqmegz: posts the ante 12
MalyshauFish: posts the ante 12
1111101000: posts the ante 12
wemax: posts the ante 12
tuvshin777: posts the ante 12
oliverdan1: posts the ante 12
ollikahn23: posts the ante 12
1JORSON: posts the ante 12
MalyshauFish: posts small blind 50
1111101000: posts big blind 100
*** HOLE CARDS ***
Dealt to ollikahn23 [5h 9c]
wemax: folds 
tuvshin777: folds 
oliverdan1: raises 100 to 200
ollikahn23: folds 
1JORSON: folds 
eqmegz: folds 
MalyshauFish: folds 
1111101000: raises 11238 to 11438 and is all-in
oliverdan1: folds 
Uncalled bet (11238) returned to 1111101000
1111101000 collected 546 from pot
1111101000: doesn't show hand 
*** SUMMARY ***
Total pot 546 | Rake 0 
Seat 1: eqmegz (button) folded before Flop (didn't bet)
Seat 2: MalyshauFish (small blind) folded before Flop
Seat 4: 1111101000 (big blind) collected (546)
Seat 5: wemax folded before Flop (didn't bet)
Seat 6: tuvshin777 folded before Flop (didn't bet)
Seat 7: oliverdan1 folded before Flop
Seat 8: ollikahn23 folded before Flop (didn't bet)
Seat 9: 1JORSON folded before Flop (didn't bet)



PokerStars Hand #185452681640: Tournament #2282606587, $13.37+$1.63 USD Hold'em No Limit - Level VI (50/100) - 2018/04/20 9:06:47 ET
Table '2282606587 6' 9-max Seat #2 is the button
Seat 1: eqmegz (3153 in chips) 
Seat 2: MalyshauFish (2093 in chips) 
Seat 4: 1111101000 (11784 in chips) 
Seat 5: wemax (5048 in chips) 
Seat 6: tuvshin777 (2835 in chips) 
Seat 7: oliverdan1 (1582 in chips) 
Seat 8: ollikahn23 (4615 in chips) 
Seat 9: 1JORSON (2710 in chips) 
eqmegz: posts the ante 12
MalyshauFish: posts the ante 12
1111101000: posts the ante 12
wemax: posts the ante 12
tuvshin777: posts the ante 12
oliverdan1: posts the ante 12
ollikahn23: posts the ante 12
1JORSON: posts the ante 12
1111101000: posts small blind 50
wemax: posts big blind 100
*** HOLE CARDS ***
Dealt to ollikahn23 [7h 5d]
tuvshin777: folds 
oliverdan1: raises 1470 to 1570 and is all-in
ollikahn23: folds 
1JORSON: folds 
eqmegz: folds 
MalyshauFish: folds 
1111101000: folds 
wemax: folds 
Uncalled bet (1470) returned to oliverdan1
oliverdan1 collected 346 from pot
oliverdan1: doesn't show hand 
*** SUMMARY ***
Total pot 346 | Rake 0 
Seat 1: eqmegz folded before Flop (didn't bet)
Seat 2: MalyshauFish (button) folded before Flop (didn't bet)
Seat 4: 1111101000 (small blind) folded before Flop
Seat 5: wemax (big blind) folded before Flop
Seat 6: tuvshin777 folded before Flop (didn't bet)
Seat 7: oliverdan1 collected (346)
Seat 8: ollikahn23 folded before Flop (didn't bet)
Seat 9: 1JORSON folded before Flop (didn't bet)



PokerStars Hand #185452692240: Tournament #2282606587, $13.37+$1.63 USD Hold'em No Limit - Level VI (50/100) - 2018/04/20 9:07:10 ET
Table '2282606587 6' 9-max Seat #4 is the button
Seat 1: eqmegz (3141 in chips) 
Seat 2: MalyshauFish (2081 in chips) 
Seat 4: 1111101000 (11722 in chips) 
Seat 5: wemax (4936 in chips) 
Seat 6: tuvshin777 (2823 in chips) 
Seat 7: oliverdan1 (1816 in chips) 
Seat 8: ollikahn23 (4603 in chips) 
Seat 9: 1JORSON (2698 in chips) 
eqmegz: posts the ante 12
MalyshauFish: posts the ante 12
1111101000: posts the ante 12
wemax: posts the ante 12
tuvshin777: posts the ante 12
oliverdan1: posts the ante 12
ollikahn23: posts the ante 12
1JORSON: posts the ante 12
wemax: posts small blind 50
tuvshin777: posts big blind 100
*** HOLE CARDS ***
Dealt to ollikahn23 [3s Jc]
oliverdan1: folds 
ollikahn23: folds 
1JORSON: folds 
eqmegz: folds 
MalyshauFish: folds 
1111101000: folds 
wemax: calls 50
tuvshin777: checks 
*** FLOP *** [Qs 3h 9h]
wemax: bets 100
tuvshin777: folds 
Uncalled bet (100) returned to wemax
wemax collected 296 from pot
wemax: doesn't show hand 
*** SUMMARY ***
Total pot 296 | Rake 0 
Board [Qs 3h 9h]
Seat 1: eqmegz folded before Flop (didn't bet)
Seat 2: MalyshauFish folded before Flop (didn't bet)
Seat 4: 1111101000 (button) folded before Flop (didn't bet)
Seat 5: wemax (small blind) collected (296)
Seat 6: tuvshin777 (big blind) folded on the Flop
Seat 7: oliverdan1 folded before Flop (didn't bet)
Seat 8: ollikahn23 folded before Flop (didn't bet)
Seat 9: 1JORSON folded before Flop (didn't bet)



PokerStars Hand #185452699785: Tournament #2282606587, $13.37+$1.63 USD Hold'em No Limit - Level VI (50/100) - 2018/04/20 9:07:26 ET
Table '2282606587 6' 9-max Seat #5 is the button
Seat 1: eqmegz (3129 in chips) 
Seat 2: MalyshauFish (2069 in chips) 
Seat 4: 1111101000 (11710 in chips) 
Seat 5: wemax (5120 in chips) 
Seat 6: tuvshin777 (2711 in chips) 
Seat 7: oliverdan1 (1804 in chips) 
Seat 8: ollikahn23 (4591 in chips) 
Seat 9: 1JORSON (2686 in chips) 
eqmegz: posts the ante 12
MalyshauFish: posts the ante 12
1111101000: posts the ante 12
wemax: posts the ante 12
tuvshin777: posts the ante 12
oliverdan1: posts the ante 12
ollikahn23: posts the ante 12
1JORSON: posts the ante 12
tuvshin777: posts small blind 50
oliverdan1: posts big blind 100
*** HOLE CARDS ***
Dealt to ollikahn23 [Qd Jc]
ollikahn23: folds 
1JORSON: folds 
eqmegz: folds 
MalyshauFish: folds 
1111101000: folds 
wemax: folds 
tuvshin777: calls 50
oliverdan1: checks 
*** FLOP *** [7c Qc 8c]
tuvshin777: checks 
oliverdan1: checks 
*** TURN *** [7c Qc 8c] [Td]
tuvshin777: checks 
oliverdan1: bets 100
tuvshin777: calls 100
*** RIVER *** [7c Qc 8c Td] [9d]
tuvshin777: checks 
oliverdan1: bets 300
tuvshin777: folds 
Uncalled bet (300) returned to oliverdan1
oliverdan1 collected 496 from pot
oliverdan1: doesn't show hand 
*** SUMMARY ***
Total pot 496 | Rake 0 
Board [7c Qc 8c Td 9d]
Seat 1: eqmegz folded before Flop (didn't bet)
Seat 2: MalyshauFish folded before Flop (didn't bet)
Seat 4: 1111101000 folded before Flop (didn't bet)
Seat 5: wemax (button) folded before Flop (didn't bet)
Seat 6: tuvshin777 (small blind) folded on the River
Seat 7: oliverdan1 (big blind) collected (496)
Seat 8: ollikahn23 folded before Flop (didn't bet)
Seat 9: 1JORSON folded before Flop (didn't bet)



PokerStars Hand #185452718518: Tournament #2282606587, $13.37+$1.63 USD Hold'em No Limit - Level VI (50/100) - 2018/04/20 9:08:06 ET
Table '2282606587 6' 9-max Seat #6 is the button
Seat 1: eqmegz (3117 in chips) 
Seat 2: MalyshauFish (2057 in chips) 
Seat 4: 1111101000 (11698 in chips) 
Seat 5: wemax (5108 in chips) 
Seat 6: tuvshin777 (2499 in chips) 
Seat 7: oliverdan1 (2088 in chips) 
Seat 8: ollikahn23 (4579 in chips) 
Seat 9: 1JORSON (2674 in chips) 
eqmegz: posts the ante 12
MalyshauFish: posts the ante 12
1111101000: posts the ante 12
wemax: posts the ante 12
tuvshin777: posts the ante 12
oliverdan1: posts the ante 12
ollikahn23: posts the ante 12
1JORSON: posts the ante 12
oliverdan1: posts small blind 50
ollikahn23: posts big blind 100
*** HOLE CARDS ***
Dealt to ollikahn23 [Jd 5c]
1JORSON: folds 
eqmegz: raises 115 to 215
MalyshauFish: folds 
1111101000: folds 
wemax: folds 
tuvshin777: calls 215
oliverdan1: folds 
ollikahn23: folds 
*** FLOP *** [Ts 8s 6s]
eqmegz: checks 
tuvshin777: bets 100
eqmegz: folds 
Uncalled bet (100) returned to tuvshin777
tuvshin777 collected 676 from pot
tuvshin777: doesn't show hand 
*** SUMMARY ***
Total pot 676 | Rake 0 
Board [Ts 8s 6s]
Seat 1: eqmegz folded on the Flop
Seat 2: MalyshauFish folded before Flop (didn't bet)
Seat 4: 1111101000 folded before Flop (didn't bet)
Seat 5: wemax folded before Flop (didn't bet)
Seat 6: tuvshin777 (button) collected (676)
Seat 7: oliverdan1 (small blind) folded before Flop
Seat 8: ollikahn23 (big blind) folded before Flop
Seat 9: 1JORSON folded before Flop (didn't bet)



PokerStars Hand #185452730274: Tournament #2282606587, $13.37+$1.63 USD Hold'em No Limit - Level VI (50/100) - 2018/04/20 9:08:32 ET
Table '2282606587 6' 9-max Seat #7 is the button
Seat 1: eqmegz (2890 in chips) 
Seat 2: MalyshauFish (2045 in chips) 
Seat 4: 1111101000 (11686 in chips) 
Seat 5: wemax (5096 in chips) 
Seat 6: tuvshin777 (2948 in chips) 
Seat 7: oliverdan1 (2026 in chips) 
Seat 8: ollikahn23 (4467 in chips) 
Seat 9: 1JORSON (2662 in chips) 
eqmegz: posts the ante 12
MalyshauFish: posts the ante 12
1111101000: posts the ante 12
wemax: posts the ante 12
tuvshin777: posts the ante 12
oliverdan1: posts the ante 12
ollikahn23: posts the ante 12
1JORSON: posts the ante 12
ollikahn23: posts small blind 50
1JORSON: posts big blind 100
*** HOLE CARDS ***
Dealt to ollikahn23 [7c 4c]
eqmegz: raises 115 to 215
MalyshauFish: folds 
1111101000: folds 
wemax: folds 
tuvshin777: folds 
oliverdan1: folds 
ollikahn23: folds 
1JORSON: folds 
Uncalled bet (115) returned to eqmegz
eqmegz collected 346 from pot
*** SUMMARY ***
Total pot 346 | Rake 0 
Seat 1: eqmegz collected (346)
Seat 2: MalyshauFish folded before Flop (didn't bet)
Seat 4: 1111101000 folded before Flop (didn't bet)
Seat 5: wemax folded before Flop (didn't bet)
Seat 6: tuvshin777 folded before Flop (didn't bet)
Seat 7: oliverdan1 (button) folded before Flop (didn't bet)
Seat 8: ollikahn23 (small blind) folded before Flop
Seat 9: 1JORSON (big blind) folded before Flop



PokerStars Hand #185452742140: Tournament #2282606587, $13.37+$1.63 USD Hold'em No Limit - Level VII (75/150) - 2018/04/20 9:08:57 ET
Table '2282606587 6' 9-max Seat #8 is the button
Seat 1: eqmegz (3124 in chips) 
Seat 2: MalyshauFish (2033 in chips) 
Seat 3: realrood (3000 in chips) 
Seat 4: 1111101000 (11674 in chips) 
Seat 5: wemax (5084 in chips) 
Seat 6: tuvshin777 (2936 in chips) 
Seat 7: oliverdan1 (2014 in chips) 
Seat 8: ollikahn23 (4405 in chips) 
Seat 9: 1JORSON (2550 in chips) 
eqmegz: posts the ante 20
MalyshauFish: posts the ante 20
realrood: posts the ante 20
1111101000: posts the ante 20
wemax: posts the ante 20
tuvshin777: posts the ante 20
oliverdan1: posts the ante 20
ollikahn23: posts the ante 20
1JORSON: posts the ante 20
1JORSON: posts small blind 75
eqmegz: posts big blind 150
*** HOLE CARDS ***
Dealt to ollikahn23 [2s As]
MalyshauFish: folds 
realrood: folds 
1111101000: folds 
wemax: folds 
tuvshin777: folds 
oliverdan1: raises 1844 to 1994 and is all-in
ollikahn23: folds 
1JORSON: folds 
eqmegz: folds 
Uncalled bet (1844) returned to oliverdan1
oliverdan1 collected 555 from pot
oliverdan1: doesn't show hand 
*** SUMMARY ***
Total pot 555 | Rake 0 
Seat 1: eqmegz (big blind) folded before Flop
Seat 2: MalyshauFish folded before Flop (didn't bet)
Seat 3: realrood folded before Flop (didn't bet)
Seat 4: 1111101000 folded before Flop (didn't bet)
Seat 5: wemax folded before Flop (didn't bet)
Seat 6: tuvshin777 folded before Flop (didn't bet)
Seat 7: oliverdan1 collected (555)
Seat 8: ollikahn23 (button) folded before Flop (didn't bet)
Seat 9: 1JORSON (small blind) folded before Flop



PokerStars Hand #185452752674: Tournament #2282606587, $13.37+$1.63 USD Hold'em No Limit - Level VII (75/150) - 2018/04/20 9:09:20 ET
Table '2282606587 6' 9-max Seat #9 is the button
Seat 1: eqmegz (2954 in chips) 
Seat 2: MalyshauFish (2013 in chips) 
Seat 3: realrood (2980 in chips) 
Seat 4: 1111101000 (11654 in chips) 
Seat 5: wemax (5064 in chips) 
Seat 6: tuvshin777 (2916 in chips) 
Seat 7: oliverdan1 (2399 in chips) 
Seat 8: ollikahn23 (4385 in chips) 
Seat 9: 1JORSON (2455 in chips) 
eqmegz: posts the ante 20
MalyshauFish: posts the ante 20
realrood: posts the ante 20
1111101000: posts the ante 20
wemax: posts the ante 20
tuvshin777: posts the ante 20
oliverdan1: posts the ante 20
ollikahn23: posts the ante 20
1JORSON: posts the ante 20
eqmegz: posts small blind 75
MalyshauFish: posts big blind 150
*** HOLE CARDS ***
Dealt to ollikahn23 [4h 9d]
realrood: folds 
1111101000: folds 
wemax: folds 
tuvshin777: folds 
oliverdan1: folds 
ollikahn23: folds 
1JORSON: folds 
eqmegz: folds 
Uncalled bet (75) returned to MalyshauFish
MalyshauFish collected 330 from pot
MalyshauFish: doesn't show hand 
*** SUMMARY ***
Total pot 330 | Rake 0 
Seat 1: eqmegz (small blind) folded before Flop
Seat 2: MalyshauFish (big blind) collected (330)
Seat 3: realrood folded before Flop (didn't bet)
Seat 4: 1111101000 folded before Flop (didn't bet)
Seat 5: wemax folded before Flop (didn't bet)
Seat 6: tuvshin777 folded before Flop (didn't bet)
Seat 7: oliverdan1 folded before Flop (didn't bet)
Seat 8: ollikahn23 folded before Flop (didn't bet)
Seat 9: 1JORSON (button) folded before Flop (didn't bet)



PokerStars Hand #185452758393: Tournament #2282606587, $13.37+$1.63 USD Hold'em No Limit - Level VII (75/150) - 2018/04/20 9:09:32 ET
Table '2282606587 6' 9-max Seat #1 is the button
Seat 1: eqmegz (2859 in chips) 
Seat 2: MalyshauFish (2248 in chips) 
Seat 3: realrood (2960 in chips) 
Seat 4: 1111101000 (11634 in chips) 
Seat 5: wemax (5044 in chips) 
Seat 6: tuvshin777 (2896 in chips) 
Seat 7: oliverdan1 (2379 in chips) 
Seat 8: ollikahn23 (4365 in chips) 
Seat 9: 1JORSON (2435 in chips) 
eqmegz: posts the ante 20
MalyshauFish: posts the ante 20
realrood: posts the ante 20
1111101000: posts the ante 20
wemax: posts the ante 20
tuvshin777: posts the ante 20
oliverdan1: posts the ante 20
ollikahn23: posts the ante 20
1JORSON: posts the ante 20
MalyshauFish: posts small blind 75
realrood: posts big blind 150
*** HOLE CARDS ***
Dealt to ollikahn23 [5d 4c]
1111101000: folds 
wemax: folds 
tuvshin777: folds 
oliverdan1: raises 2209 to 2359 and is all-in
ollikahn23: folds 
1JORSON: folds 
eqmegz: folds 
MalyshauFish: folds 
realrood: calls 2209
*** FLOP *** [As Qs 9h]
*** TURN *** [As Qs 9h] [9s]
*** RIVER *** [As Qs 9h 9s] [4h]
*** SHOW DOWN ***
realrood: shows [Kd Ad] (two pair, Aces and Nines)
oliverdan1: shows [Ah Jh] (two pair, Aces and Nines - lower kicker)
realrood collected 4973 from pot
oliverdan1 finished the tournament
*** SUMMARY ***
Total pot 4973 | Rake 0 
Board [As Qs 9h 9s 4h]
Seat 1: eqmegz (button) folded before Flop (didn't bet)
Seat 2: MalyshauFish (small blind) folded before Flop
Seat 3: realrood (big blind) showed [Kd Ad] and won (4973) with two pair, Aces and Nines
Seat 4: 1111101000 folded before Flop (didn't bet)
Seat 5: wemax folded before Flop (didn't bet)
Seat 6: tuvshin777 folded before Flop (didn't bet)
Seat 7: oliverdan1 showed [Ah Jh] and lost with two pair, Aces and Nines
Seat 8: ollikahn23 folded before Flop (didn't bet)
Seat 9: 1JORSON folded before Flop (didn't bet)



PokerStars Hand #185452772764: Tournament #2282606587, $13.37+$1.63 USD Hold'em No Limit - Level VII (75/150) - 2018/04/20 9:10:03 ET
Table '2282606587 6' 9-max Seat #2 is the button
Seat 1: eqmegz (2839 in chips) 
Seat 2: MalyshauFish (2153 in chips) 
Seat 3: realrood (5554 in chips) 
Seat 4: 1111101000 (11614 in chips) 
Seat 5: wemax (5024 in chips) 
Seat 6: tuvshin777 (2876 in chips) 
Seat 8: ollikahn23 (4345 in chips) 
Seat 9: 1JORSON (2415 in chips) 
eqmegz: posts the ante 20
MalyshauFish: posts the ante 20
realrood: posts the ante 20
1111101000: posts the ante 20
wemax: posts the ante 20
tuvshin777: posts the ante 20
ollikahn23: posts the ante 20
1JORSON: posts the ante 20
realrood: posts small blind 75
1111101000: posts big blind 150
*** HOLE CARDS ***
Dealt to ollikahn23 [7h 3d]
wemax: folds 
tuvshin777: folds 
ollikahn23: folds 
1JORSON: folds 
eqmegz: folds 
MalyshauFish: folds 
realrood: calls 75
1111101000: raises 364 to 514
realrood: calls 364
*** FLOP *** [6c 7c Kh]
realrood: checks 
1111101000: bets 535
realrood: folds 
Uncalled bet (535) returned to 1111101000
1111101000 collected 1188 from pot
1111101000: doesn't show hand 
*** SUMMARY ***
Total pot 1188 | Rake 0 
Board [6c 7c Kh]
Seat 1: eqmegz folded before Flop (didn't bet)
Seat 2: MalyshauFish (button) folded before Flop (didn't bet)
Seat 3: realrood (small blind) folded on the Flop
Seat 4: 1111101000 (big blind) collected (1188)
Seat 5: wemax folded before Flop (didn't bet)
Seat 6: tuvshin777 folded before Flop (didn't bet)
Seat 8: ollikahn23 folded before Flop (didn't bet)
Seat 9: 1JORSON folded before Flop (didn't bet)



PokerStars Hand #185452792007: Tournament #2282606587, $13.37+$1.63 USD Hold'em No Limit - Level VII (75/150) - 2018/04/20 9:10:44 ET
Table '2282606587 6' 9-max Seat #3 is the button
Seat 1: eqmegz (2819 in chips) 
Seat 2: MalyshauFish (2133 in chips) 
Seat 3: realrood (5020 in chips) 
Seat 4: 1111101000 (12268 in chips) 
Seat 5: wemax (5004 in chips) 
Seat 6: tuvshin777 (2856 in chips) 
Seat 7: Sivian (3000 in chips) 
Seat 8: ollikahn23 (4325 in chips) 
Seat 9: 1JORSON (2395 in chips) 
eqmegz: posts the ante 20
MalyshauFish: posts the ante 20
realrood: posts the ante 20
1111101000: posts the ante 20
wemax: posts the ante 20
tuvshin777: posts the ante 20
Sivian: posts the ante 20
ollikahn23: posts the ante 20
1JORSON: posts the ante 20
1111101000: posts small blind 75
wemax: posts big blind 150
*** HOLE CARDS ***
Dealt to ollikahn23 [Kd 7s]
tuvshin777: folds 
Sivian: folds 
ollikahn23: folds 
1JORSON: folds 
eqmegz: folds 
MalyshauFish: folds 
realrood: folds 
1111101000: raises 12098 to 12248 and is all-in
wemax: folds 
Uncalled bet (12098) returned to 1111101000
1111101000 collected 480 from pot
1111101000: doesn't show hand 
*** SUMMARY ***
Total pot 480 | Rake 0 
Seat 1: eqmegz folded before Flop (didn't bet)
Seat 2: MalyshauFish folded before Flop (didn't bet)
Seat 3: realrood (button) folded before Flop (didn't bet)
Seat 4: 1111101000 (small blind) collected (480)
Seat 5: wemax (big blind) folded before Flop
Seat 6: tuvshin777 folded before Flop (didn't bet)
Seat 7: Sivian folded before Flop (didn't bet)
Seat 8: ollikahn23 folded before Flop (didn't bet)
Seat 9: 1JORSON folded before Flop (didn't bet)



PokerStars Hand #185452808295: Tournament #2282606587, $13.37+$1.63 USD Hold'em No Limit - Level VII (75/150) - 2018/04/20 9:11:19 ET
Table '2282606587 6' 9-max Seat #4 is the button
Seat 1: eqmegz (2799 in chips) 
Seat 2: MalyshauFish (2113 in chips) 
Seat 3: realrood (5000 in chips) 
Seat 4: 1111101000 (12578 in chips) 
Seat 5: wemax (4834 in chips) 
Seat 6: tuvshin777 (2836 in chips) 
Seat 7: Sivian (2980 in chips) 
Seat 8: ollikahn23 (4305 in chips) 
Seat 9: 1JORSON (2375 in chips) 
eqmegz: posts the ante 20
MalyshauFish: posts the ante 20
realrood: posts the ante 20
1111101000: posts the ante 20
wemax: posts the ante 20
tuvshin777: posts the ante 20
Sivian: posts the ante 20
ollikahn23: posts the ante 20
1JORSON: posts the ante 20
wemax: posts small blind 75
tuvshin777: posts big blind 150
*** HOLE CARDS ***
Dealt to ollikahn23 [Ad 7d]
Sivian: folds 
ollikahn23: raises 155 to 305
1JORSON: folds 
eqmegz: folds 
MalyshauFish: folds 
realrood: folds 
1111101000: folds 
wemax: folds 
tuvshin777: calls 155
*** FLOP *** [4d 8s 3s]
tuvshin777: checks 
ollikahn23: bets 350
tuvshin777: calls 350
*** TURN *** [4d 8s 3s] [Th]
tuvshin777: checks 
ollikahn23: bets 600
tuvshin777: folds 
Uncalled bet (600) returned to ollikahn23
ollikahn23 collected 1565 from pot
ollikahn23: doesn't show hand 
*** SUMMARY ***
Total pot 1565 | Rake 0 
Board [4d 8s 3s Th]
Seat 1: eqmegz folded before Flop (didn't bet)
Seat 2: MalyshauFish folded before Flop (didn't bet)
Seat 3: realrood folded before Flop (didn't bet)
Seat 4: 1111101000 (button) folded before Flop (didn't bet)
Seat 5: wemax (small blind) folded before Flop
Seat 6: tuvshin777 (big blind) folded on the Turn
Seat 7: Sivian folded before Flop (didn't bet)
Seat 8: ollikahn23 collected (1565)
Seat 9: 1JORSON folded before Flop (didn't bet)



PokerStars Hand #185452840234: Tournament #2282606587, $13.37+$1.63 USD Hold'em No Limit - Level VII (75/150) - 2018/04/20 9:12:28 ET
Table '2282606587 6' 9-max Seat #5 is the button
Seat 1: eqmegz (2779 in chips) 
Seat 2: MalyshauFish (2093 in chips) 
Seat 3: realrood (4980 in chips) 
Seat 4: 1111101000 (12558 in chips) 
Seat 5: wemax (4739 in chips) 
Seat 6: tuvshin777 (2161 in chips) 
Seat 7: Sivian (2960 in chips) 
Seat 8: ollikahn23 (5195 in chips) 
Seat 9: 1JORSON (2355 in chips) 
eqmegz: posts the ante 20
MalyshauFish: posts the ante 20
realrood: posts the ante 20
1111101000: posts the ante 20
wemax: posts the ante 20
tuvshin777: posts the ante 20
Sivian: posts the ante 20
ollikahn23: posts the ante 20
1JORSON: posts the ante 20
tuvshin777: posts small blind 75
Sivian: posts big blind 150
*** HOLE CARDS ***
Dealt to ollikahn23 [Ac 8h]
ollikahn23: folds 
1JORSON: folds 
eqmegz: folds 
MalyshauFish: raises 1923 to 2073 and is all-in
realrood: folds 
1111101000: folds 
wemax: folds 
tuvshin777: folds 
Sivian: folds 
Uncalled bet (1923) returned to MalyshauFish
MalyshauFish collected 555 from pot
MalyshauFish: doesn't show hand 
*** SUMMARY ***
Total pot 555 | Rake 0 
Seat 1: eqmegz folded before Flop (didn't bet)
Seat 2: MalyshauFish collected (555)
Seat 3: realrood folded before Flop (didn't bet)
Seat 4: 1111101000 folded before Flop (didn't bet)
Seat 5: wemax (button) folded before Flop (didn't bet)
Seat 6: tuvshin777 (small blind) folded before Flop
Seat 7: Sivian (big blind) folded before Flop
Seat 8: ollikahn23 folded before Flop (didn't bet)
Seat 9: 1JORSON folded before Flop (didn't bet)



PokerStars Hand #185452853903: Tournament #2282606587, $13.37+$1.63 USD Hold'em No Limit - Level VII (75/150) - 2018/04/20 9:12:57 ET
Table '2282606587 6' 9-max Seat #6 is the button
Seat 1: eqmegz (2759 in chips) 
Seat 2: MalyshauFish (2478 in chips) 
Seat 3: realrood (4960 in chips) 
Seat 5: wemax (4719 in chips) 
Seat 6: tuvshin777 (2066 in chips) 
Seat 7: Sivian (2790 in chips) 
Seat 8: ollikahn23 (5175 in chips) 
Seat 9: 1JORSON (2335 in chips) 
eqmegz: posts the ante 20
MalyshauFish: posts the ante 20
realrood: posts the ante 20
wemax: posts the ante 20
tuvshin777: posts the ante 20
Sivian: posts the ante 20
ollikahn23: posts the ante 20
1JORSON: posts the ante 20
Sivian: posts small blind 75
ollikahn23: posts big blind 150
*** HOLE CARDS ***
Dealt to ollikahn23 [6d 6h]
1JORSON: folds 
eqmegz: folds 
MalyshauFish: folds 
realrood: folds 
wemax: folds 
tuvshin777: folds 
Sivian: folds 
Uncalled bet (75) returned to ollikahn23
ollikahn23 collected 310 from pot
ollikahn23: doesn't show hand 
*** SUMMARY ***
Total pot 310 | Rake 0 
Seat 1: eqmegz folded before Flop (didn't bet)
Seat 2: MalyshauFish folded before Flop (didn't bet)
Seat 3: realrood folded before Flop (didn't bet)
Seat 5: wemax folded before Flop (didn't bet)
Seat 6: tuvshin777 (button) folded before Flop (didn't bet)
Seat 7: Sivian (small blind) folded before Flop
Seat 8: ollikahn23 (big blind) collected (310)
Seat 9: 1JORSON folded before Flop (didn't bet)



PokerStars Hand #185452862982: Tournament #2282606587, $13.37+$1.63 USD Hold'em No Limit - Level VII (75/150) - 2018/04/20 9:13:16 ET
Table '2282606587 6' 9-max Seat #7 is the button
Seat 1: eqmegz (2739 in chips) 
Seat 2: MalyshauFish (2458 in chips) 
Seat 3: realrood (4940 in chips) 
Seat 5: wemax (4699 in chips) 
Seat 6: tuvshin777 (2046 in chips) 
Seat 7: Sivian (2695 in chips) 
Seat 8: ollikahn23 (5390 in chips) 
Seat 9: 1JORSON (2315 in chips) 
eqmegz: posts the ante 20
MalyshauFish: posts the ante 20
realrood: posts the ante 20
wemax: posts the ante 20
tuvshin777: posts the ante 20
Sivian: posts the ante 20
ollikahn23: posts the ante 20
1JORSON: posts the ante 20
ollikahn23: posts small blind 75
1JORSON: posts big blind 150
*** HOLE CARDS ***
Dealt to ollikahn23 [5c 8c]
eqmegz: folds 
MalyshauFish: folds 
realrood: folds 
wemax: folds 
tuvshin777: raises 150 to 300
Sivian: calls 300
ollikahn23: folds 
1JORSON: folds 
*** FLOP *** [4d 7s Ad]
tuvshin777: checks 
Sivian: checks 
*** TURN *** [4d 7s Ad] [3c]
tuvshin777: bets 300
Sivian: raises 2075 to 2375 and is all-in
tuvshin777: calls 1426 and is all-in
Uncalled bet (649) returned to Sivian
*** RIVER *** [4d 7s Ad 3c] [4s]
*** SHOW DOWN ***
tuvshin777: shows [Ah Ac] (a full house, Aces full of Fours)
Sivian: shows [9c Jc] (a pair of Fours)
tuvshin777 collected 4437 from pot
*** SUMMARY ***
Total pot 4437 | Rake 0 
Board [4d 7s Ad 3c 4s]
Seat 1: eqmegz folded before Flop (didn't bet)
Seat 2: MalyshauFish folded before Flop (didn't bet)
Seat 3: realrood folded before Flop (didn't bet)
Seat 5: wemax folded before Flop (didn't bet)
Seat 6: tuvshin777 showed [Ah Ac] and won (4437) with a full house, Aces full of Fours
Seat 7: Sivian (button) showed [9c Jc] and lost with a pair of Fours
Seat 8: ollikahn23 (small blind) folded before Flop
Seat 9: 1JORSON (big blind) folded before Flop



PokerStars Hand #185452880843: Tournament #2282606587, $13.37+$1.63 USD Hold'em No Limit - Level VII (75/150) - 2018/04/20 9:13:54 ET
Table '2282606587 6' 9-max Seat #8 is the button
Seat 1: eqmegz (2719 in chips) 
Seat 2: MalyshauFish (2438 in chips) 
Seat 3: realrood (4920 in chips) 
Seat 5: wemax (4679 in chips) 
Seat 6: tuvshin777 (4437 in chips) 
Seat 7: Sivian (649 in chips) 
Seat 8: ollikahn23 (5295 in chips) 
Seat 9: 1JORSON (2145 in chips) 
eqmegz: posts the ante 20
MalyshauFish: posts the ante 20
realrood: posts the ante 20
wemax: posts the ante 20
tuvshin777: posts the ante 20
Sivian: posts the ante 20
ollikahn23: posts the ante 20
1JORSON: posts the ante 20
1JORSON: posts small blind 75
eqmegz: posts big blind 150
*** HOLE CARDS ***
Dealt to ollikahn23 [Qs Ah]
MalyshauFish: folds 
realrood: raises 165 to 315
wemax: folds 
tuvshin777: folds 
Sivian: folds 
ollikahn23: raises 165 to 480
1JORSON: folds 
eqmegz: folds 
realrood: calls 165
*** FLOP *** [4d 5c Qh]
realrood: checks 
ollikahn23: bets 600
realrood: folds 
Uncalled bet (600) returned to ollikahn23
ollikahn23 collected 1345 from pot
ollikahn23: doesn't show hand 
*** SUMMARY ***
Total pot 1345 | Rake 0 
Board [4d 5c Qh]
Seat 1: eqmegz (big blind) folded before Flop
Seat 2: MalyshauFish folded before Flop (didn't bet)
Seat 3: realrood folded on the Flop
Seat 5: wemax folded before Flop (didn't bet)
Seat 6: tuvshin777 folded before Flop (didn't bet)
Seat 7: Sivian folded before Flop (didn't bet)
Seat 8: ollikahn23 (button) collected (1345)
Seat 9: 1JORSON (small blind) folded before Flop



PokerStars Hand #185452900530: Tournament #2282606587, $13.37+$1.63 USD Hold'em No Limit - Level VII (75/150) - 2018/04/20 9:14:36 ET
Table '2282606587 6' 9-max Seat #9 is the button
Seat 1: eqmegz (2549 in chips) 
Seat 2: MalyshauFish (2418 in chips) 
Seat 3: realrood (4420 in chips) 
Seat 5: wemax (4659 in chips) 
Seat 6: tuvshin777 (4417 in chips) 
Seat 7: Sivian (629 in chips) 
Seat 8: ollikahn23 (6140 in chips) 
Seat 9: 1JORSON (2050 in chips) 
eqmegz: posts the ante 20
MalyshauFish: posts the ante 20
realrood: posts the ante 20
wemax: posts the ante 20
tuvshin777: posts the ante 20
Sivian: posts the ante 20
ollikahn23: posts the ante 20
1JORSON: posts the ante 20
eqmegz: posts small blind 75
MalyshauFish: posts big blind 150
*** HOLE CARDS ***
Dealt to ollikahn23 [Kc Tc]
realrood: folds 
wemax: folds 
tuvshin777: folds 
Sivian: folds 
ollikahn23: raises 155 to 305
1JORSON: raises 1725 to 2030 and is all-in
eqmegz: folds 
MalyshauFish: folds 
ollikahn23: calls 1725
*** FLOP *** [Td Qh 9s]
*** TURN *** [Td Qh 9s] [As]
*** RIVER *** [Td Qh 9s As] [5h]
*** SHOW DOWN ***
ollikahn23: shows [Kc Tc] (a pair of Tens)
1JORSON: shows [Kd Ah] (a pair of Aces)
1JORSON collected 4445 from pot
*** SUMMARY ***
Total pot 4445 | Rake 0 
Board [Td Qh 9s As 5h]
Seat 1: eqmegz (small blind) folded before Flop
Seat 2: MalyshauFish (big blind) folded before Flop
Seat 3: realrood folded before Flop (didn't bet)
Seat 5: wemax folded before Flop (didn't bet)
Seat 6: tuvshin777 folded before Flop (didn't bet)
Seat 7: Sivian folded before Flop (didn't bet)
Seat 8: ollikahn23 showed [Kc Tc] and lost with a pair of Tens
Seat 9: 1JORSON (button) showed [Kd Ah] and won (4445) with a pair of Aces



PokerStars Hand #185452927035: Tournament #2282606587, $13.37+$1.63 USD Hold'em No Limit - Level VII (75/150) - 2018/04/20 9:15:33 ET
Table '2282606587 6' 9-max Seat #1 is the button
Seat 1: eqmegz (2454 in chips) 
Seat 2: MalyshauFish (2248 in chips) 
Seat 4: comeecome88 (3000 in chips) 
Seat 5: wemax (4639 in chips) 
Seat 6: tuvshin777 (4397 in chips) 
Seat 7: Sivian (609 in chips) 
Seat 8: ollikahn23 (4090 in chips) 
Seat 9: 1JORSON (4445 in chips) 
eqmegz: posts the ante 20
MalyshauFish: posts the ante 20
comeecome88: posts the ante 20
wemax: posts the ante 20
tuvshin777: posts the ante 20
Sivian: posts the ante 20
ollikahn23: posts the ante 20
1JORSON: posts the ante 20
MalyshauFish: posts small blind 75
comeecome88: posts big blind 150
*** HOLE CARDS ***
Dealt to ollikahn23 [3d 6c]
wemax: folds 
tuvshin777: folds 
Sivian: raises 439 to 589 and is all-in
ollikahn23: folds 
1JORSON: folds 
eqmegz: folds 
MalyshauFish: folds 
comeecome88: calls 439
*** FLOP *** [Ah Ac Qh]
*** TURN *** [Ah Ac Qh] [Ts]
*** RIVER *** [Ah Ac Qh Ts] [9d]
*** SHOW DOWN ***
comeecome88: shows [8s 9s] (two pair, Aces and Nines)
Sivian: shows [7h 7c] (two pair, Aces and Sevens)
comeecome88 collected 1413 from pot
Sivian finished the tournament
*** SUMMARY ***
Total pot 1413 | Rake 0 
Board [Ah Ac Qh Ts 9d]
Seat 1: eqmegz (button) folded before Flop (didn't bet)
Seat 2: MalyshauFish (small blind) folded before Flop
Seat 4: comeecome88 (big blind) showed [8s 9s] and won (1413) with two pair, Aces and Nines
Seat 5: wemax folded before Flop (didn't bet)
Seat 6: tuvshin777 folded before Flop (didn't bet)
Seat 7: Sivian showed [7h 7c] and lost with two pair, Aces and Sevens
Seat 8: ollikahn23 folded before Flop (didn't bet)
Seat 9: 1JORSON folded before Flop (didn't bet)



PokerStars Hand #185452938666: Tournament #2282606587, $13.37+$1.63 USD Hold'em No Limit - Level VII (75/150) - 2018/04/20 9:15:57 ET
Table '2282606587 6' 9-max Seat #2 is the button
Seat 1: eqmegz (2434 in chips) 
Seat 2: MalyshauFish (2153 in chips) 
Seat 4: comeecome88 (3804 in chips) 
Seat 5: wemax (4619 in chips) 
Seat 6: tuvshin777 (4377 in chips) 
Seat 8: ollikahn23 (4070 in chips) 
Seat 9: 1JORSON (4425 in chips) 
eqmegz: posts the ante 20
MalyshauFish: posts the ante 20
comeecome88: posts the ante 20
wemax: posts the ante 20
tuvshin777: posts the ante 20
ollikahn23: posts the ante 20
1JORSON: posts the ante 20
comeecome88: posts small blind 75
wemax: posts big blind 150
*** HOLE CARDS ***
Dealt to ollikahn23 [Tc 7h]
tuvshin777: folds 
ollikahn23: folds 
1JORSON: folds 
eqmegz: raises 172 to 322
MalyshauFish: folds 
comeecome88: folds 
wemax: folds 
Uncalled bet (172) returned to eqmegz
eqmegz collected 515 from pot
*** SUMMARY ***
Total pot 515 | Rake 0 
Seat 1: eqmegz collected (515)
Seat 2: MalyshauFish (button) folded before Flop (didn't bet)
Seat 4: comeecome88 (small blind) folded before Flop
Seat 5: wemax (big blind) folded before Flop
Seat 6: tuvshin777 folded before Flop (didn't bet)
Seat 8: ollikahn23 folded before Flop (didn't bet)
Seat 9: 1JORSON folded before Flop (didn't bet)



PokerStars Hand #185452950495: Tournament #2282606587, $13.37+$1.63 USD Hold'em No Limit - Level VII (75/150) - 2018/04/20 9:16:22 ET
Table '2282606587 6' 9-max Seat #4 is the button
Seat 1: eqmegz (2779 in chips) 
Seat 2: MalyshauFish (2133 in chips) 
Seat 4: comeecome88 (3709 in chips) 
Seat 5: wemax (4449 in chips) 
Seat 6: tuvshin777 (4357 in chips) 
Seat 7: crazysit (2840 in chips) 
Seat 8: ollikahn23 (4050 in chips) 
Seat 9: 1JORSON (4405 in chips) 
eqmegz: posts the ante 20
MalyshauFish: posts the ante 20
comeecome88: posts the ante 20
wemax: posts the ante 20
tuvshin777: posts the ante 20
crazysit: posts the ante 20
ollikahn23: posts the ante 20
1JORSON: posts the ante 20
wemax: posts small blind 75
tuvshin777: posts big blind 150
*** HOLE CARDS ***
Dealt to ollikahn23 [Tc Jc]
crazysit: folds 
ollikahn23: folds 
1JORSON: folds 
eqmegz: raises 172 to 322
MalyshauFish: raises 1791 to 2113 and is all-in
comeecome88: folds 
wemax: folds 
tuvshin777: folds 
eqmegz: folds 
Uncalled bet (1791) returned to MalyshauFish
MalyshauFish collected 1029 from pot
MalyshauFish: doesn't show hand 
*** SUMMARY ***
Total pot 1029 | Rake 0 
Seat 1: eqmegz folded before Flop
Seat 2: MalyshauFish collected (1029)
Seat 4: comeecome88 (button) folded before Flop (didn't bet)
Seat 5: wemax (small blind) folded before Flop
Seat 6: tuvshin777 (big blind) folded before Flop
Seat 7: crazysit folded before Flop (didn't bet)
Seat 8: ollikahn23 folded before Flop (didn't bet)
Seat 9: 1JORSON folded before Flop (didn't bet)



PokerStars Hand #185452962267: Tournament #2282606587, $13.37+$1.63 USD Hold'em No Limit - Level VII (75/150) - 2018/04/20 9:16:47 ET
Table '2282606587 6' 9-max Seat #5 is the button
Seat 1: eqmegz (2437 in chips) 
Seat 2: MalyshauFish (2820 in chips) 
Seat 4: comeecome88 (3689 in chips) 
Seat 5: wemax (4354 in chips) 
Seat 6: tuvshin777 (4187 in chips) 
Seat 7: crazysit (2820 in chips) 
Seat 8: ollikahn23 (4030 in chips) 
Seat 9: 1JORSON (4385 in chips) 
eqmegz: posts the ante 20
MalyshauFish: posts the ante 20
comeecome88: posts the ante 20
wemax: posts the ante 20
tuvshin777: posts the ante 20
crazysit: posts the ante 20
ollikahn23: posts the ante 20
1JORSON: posts the ante 20
tuvshin777: posts small blind 75
crazysit: posts big blind 150
*** HOLE CARDS ***
Dealt to ollikahn23 [2c 8h]
ollikahn23: folds 
1JORSON: folds 
eqmegz: folds 
MalyshauFish: raises 150 to 300
comeecome88: folds 
wemax: calls 300
tuvshin777: calls 225
crazysit: calls 150
*** FLOP *** [7h Jd 8d]
tuvshin777: checks 
crazysit: checks 
MalyshauFish: checks 
wemax: bets 650
tuvshin777: folds 
crazysit: folds 
MalyshauFish: folds 
Uncalled bet (650) returned to wemax
wemax collected 1360 from pot
wemax: doesn't show hand 
*** SUMMARY ***
Total pot 1360 | Rake 0 
Board [7h Jd 8d]
Seat 1: eqmegz folded before Flop (didn't bet)
Seat 2: MalyshauFish folded on the Flop
Seat 4: comeecome88 folded before Flop (didn't bet)
Seat 5: wemax (button) collected (1360)
Seat 6: tuvshin777 (small blind) folded on the Flop
Seat 7: crazysit (big blind) folded on the Flop
Seat 8: ollikahn23 folded before Flop (didn't bet)
Seat 9: 1JORSON folded before Flop (didn't bet)



PokerStars Hand #185452978705: Tournament #2282606587, $13.37+$1.63 USD Hold'em No Limit - Level VII (75/150) - 2018/04/20 9:17:22 ET
Table '2282606587 6' 9-max Seat #6 is the button
Seat 1: eqmegz (2417 in chips) 
Seat 2: MalyshauFish (2500 in chips) 
Seat 4: comeecome88 (3669 in chips) 
Seat 5: wemax (5394 in chips) 
Seat 6: tuvshin777 (3867 in chips) 
Seat 7: crazysit (2500 in chips) 
Seat 8: ollikahn23 (4010 in chips) 
Seat 9: 1JORSON (4365 in chips) 
eqmegz: posts the ante 20
MalyshauFish: posts the ante 20
comeecome88: posts the ante 20
wemax: posts the ante 20
tuvshin777: posts the ante 20
crazysit: posts the ante 20
ollikahn23: posts the ante 20
1JORSON: posts the ante 20
crazysit: posts small blind 75
ollikahn23: posts big blind 150
*** HOLE CARDS ***
Dealt to ollikahn23 [7c 4c]
1JORSON: folds 
eqmegz: folds 
MalyshauFish: folds 
comeecome88: raises 150 to 300
wemax: calls 300
tuvshin777: folds 
crazysit: folds 
ollikahn23: calls 150
*** FLOP *** [9d 9s 9c]
ollikahn23: checks 
comeecome88: checks 
wemax: checks 
*** TURN *** [9d 9s 9c] [5d]
ollikahn23: bets 355
comeecome88: folds 
wemax: folds 
Uncalled bet (355) returned to ollikahn23
ollikahn23 collected 1135 from pot
ollikahn23: doesn't show hand 
*** SUMMARY ***
Total pot 1135 | Rake 0 
Board [9d 9s 9c 5d]
Seat 1: eqmegz folded before Flop (didn't bet)
Seat 2: MalyshauFish folded before Flop (didn't bet)
Seat 4: comeecome88 folded on the Turn
Seat 5: wemax folded on the Turn
Seat 6: tuvshin777 (button) folded before Flop (didn't bet)
Seat 7: crazysit (small blind) folded before Flop
Seat 8: ollikahn23 (big blind) collected (1135)
Seat 9: 1JORSON folded before Flop (didn't bet)



PokerStars Hand #185453002540: Tournament #2282606587, $13.37+$1.63 USD Hold'em No Limit - Level VII (75/150) - 2018/04/20 9:18:13 ET
Table '2282606587 6' 9-max Seat #7 is the button
Seat 1: eqmegz (2397 in chips) 
Seat 3: Vlad0184 (10320 in chips) 
Seat 4: comeecome88 (3349 in chips) 
Seat 5: wemax (5074 in chips) 
Seat 6: tuvshin777 (3847 in chips) 
Seat 7: crazysit (2405 in chips) 
Seat 8: ollikahn23 (4825 in chips) 
Seat 9: 1JORSON (4345 in chips) 
eqmegz: posts the ante 20
Vlad0184: posts the ante 20
comeecome88: posts the ante 20
wemax: posts the ante 20
tuvshin777: posts the ante 20
crazysit: posts the ante 20
ollikahn23: posts the ante 20
1JORSON: posts the ante 20
ollikahn23: posts small blind 75
1JORSON: posts big blind 150
*** HOLE CARDS ***
Dealt to ollikahn23 [Jc 5d]
eqmegz: raises 172 to 322
Vlad0184: folds 
comeecome88: folds 
wemax: folds 
tuvshin777: folds 
crazysit: folds 
ollikahn23: folds 
1JORSON: calls 172
*** FLOP *** [Td 5c 9d]
1JORSON: checks 
eqmegz: bets 352
1JORSON: folds 
Uncalled bet (352) returned to eqmegz
eqmegz collected 879 from pot
*** SUMMARY ***
Total pot 879 | Rake 0 
Board [Td 5c 9d]
Seat 1: eqmegz collected (879)
Seat 3: Vlad0184 folded before Flop (didn't bet)
Seat 4: comeecome88 folded before Flop (didn't bet)
Seat 5: wemax folded before Flop (didn't bet)
Seat 6: tuvshin777 folded before Flop (didn't bet)
Seat 7: crazysit (button) folded before Flop (didn't bet)
Seat 8: ollikahn23 (small blind) folded before Flop
Seat 9: 1JORSON (big blind) folded on the Flop



PokerStars Hand #185453024787: Tournament #2282606587, $13.37+$1.63 USD Hold'em No Limit - Level VIII (100/200) - 2018/04/20 9:19:01 ET
Table '2282606587 6' 9-max Seat #8 is the button
Seat 1: eqmegz (2934 in chips) 
Seat 2: Derelick7 (3000 in chips) 
Seat 3: Vlad0184 (10300 in chips) 
Seat 4: comeecome88 (3329 in chips) 
Seat 5: wemax (5054 in chips) 
Seat 6: tuvshin777 (3827 in chips) 
Seat 7: crazysit (2385 in chips) 
Seat 8: ollikahn23 (4730 in chips) 
Seat 9: 1JORSON (4003 in chips) 
eqmegz: posts the ante 25
Derelick7: posts the ante 25
Vlad0184: posts the ante 25
comeecome88: posts the ante 25
wemax: posts the ante 25
tuvshin777: posts the ante 25
crazysit: posts the ante 25
ollikahn23: posts the ante 25
1JORSON: posts the ante 25
1JORSON: posts small blind 100
eqmegz: posts big blind 200
*** HOLE CARDS ***
Dealt to ollikahn23 [5h 8s]
Derelick7: folds 
Vlad0184: folds 
comeecome88: folds 
wemax: folds 
tuvshin777: folds 
crazysit: raises 2160 to 2360 and is all-in
ollikahn23: folds 
1JORSON: folds 
eqmegz: folds 
Uncalled bet (2160) returned to crazysit
crazysit collected 725 from pot
crazysit: doesn't show hand 
*** SUMMARY ***
Total pot 725 | Rake 0 
Seat 1: eqmegz (big blind) folded before Flop
Seat 2: Derelick7 folded before Flop (didn't bet)
Seat 3: Vlad0184 folded before Flop (didn't bet)
Seat 4: comeecome88 folded before Flop (didn't bet)
Seat 5: wemax folded before Flop (didn't bet)
Seat 6: tuvshin777 folded before Flop (didn't bet)
Seat 7: crazysit collected (725)
Seat 8: ollikahn23 (button) folded before Flop (didn't bet)
Seat 9: 1JORSON (small blind) folded before Flop



PokerStars Hand #185453035072: Tournament #2282606587, $13.37+$1.63 USD Hold'em No Limit - Level VIII (100/200) - 2018/04/20 9:19:23 ET
Table '2282606587 6' 9-max Seat #9 is the button
Seat 1: eqmegz (2709 in chips) 
Seat 2: Derelick7 (2975 in chips) 
Seat 3: Vlad0184 (10275 in chips) 
Seat 4: comeecome88 (3304 in chips) 
Seat 5: wemax (5029 in chips) 
Seat 6: tuvshin777 (3802 in chips) 
Seat 7: crazysit (2885 in chips) 
Seat 8: ollikahn23 (4705 in chips) 
Seat 9: 1JORSON (3878 in chips) 
eqmegz: posts the ante 25
Derelick7: posts the ante 25
Vlad0184: posts the ante 25
comeecome88: posts the ante 25
wemax: posts the ante 25
tuvshin777: posts the ante 25
crazysit: posts the ante 25
ollikahn23: posts the ante 25
1JORSON: posts the ante 25
eqmegz: posts small blind 100
Derelick7: posts big blind 200
*** HOLE CARDS ***
Dealt to ollikahn23 [7h 2c]
Vlad0184: folds 
comeecome88: folds 
wemax: folds 
tuvshin777: raises 200 to 400
crazysit: folds 
ollikahn23: folds 
1JORSON: folds 
eqmegz: folds 
Derelick7: folds 
Uncalled bet (200) returned to tuvshin777
tuvshin777 collected 725 from pot
tuvshin777: doesn't show hand 
*** SUMMARY ***
Total pot 725 | Rake 0 
Seat 1: eqmegz (small blind) folded before Flop
Seat 2: Derelick7 (big blind) folded before Flop
Seat 3: Vlad0184 folded before Flop (didn't bet)
Seat 4: comeecome88 folded before Flop (didn't bet)
Seat 5: wemax folded before Flop (didn't bet)
Seat 6: tuvshin777 collected (725)
Seat 7: crazysit folded before Flop (didn't bet)
Seat 8: ollikahn23 folded before Flop (didn't bet)
Seat 9: 1JORSON (button) folded before Flop (didn't bet)



PokerStars Hand #185453046661: Tournament #2282606587, $13.37+$1.63 USD Hold'em No Limit - Level VIII (100/200) - 2018/04/20 9:19:48 ET
Table '2282606587 6' 9-max Seat #1 is the button
Seat 1: eqmegz (2584 in chips) 
Seat 2: Derelick7 (2750 in chips) 
Seat 3: Vlad0184 (10250 in chips) 
Seat 4: comeecome88 (3279 in chips) 
Seat 6: tuvshin777 (4302 in chips) 
Seat 7: crazysit (2860 in chips) 
Seat 8: ollikahn23 (4680 in chips) 
Seat 9: 1JORSON (3853 in chips) 
eqmegz: posts the ante 25
Derelick7: posts the ante 25
Vlad0184: posts the ante 25
comeecome88: posts the ante 25
tuvshin777: posts the ante 25
crazysit: posts the ante 25
ollikahn23: posts the ante 25
1JORSON: posts the ante 25
Derelick7: posts small blind 100
Vlad0184: posts big blind 200
*** HOLE CARDS ***
Dealt to ollikahn23 [5s Kd]
comeecome88: folds 
tuvshin777: folds 
crazysit: folds 
ollikahn23: raises 205 to 405
1JORSON: calls 405
eqmegz: folds 
Derelick7: folds 
Vlad0184: folds 
*** FLOP *** [Td Ac 8c]
ollikahn23: bets 555
1JORSON: calls 555
*** TURN *** [Td Ac 8c] [3s]
ollikahn23: bets 1110
1JORSON: folds 
Uncalled bet (1110) returned to ollikahn23
ollikahn23 collected 2420 from pot
ollikahn23: doesn't show hand 
*** SUMMARY ***
Total pot 2420 | Rake 0 
Board [Td Ac 8c 3s]
Seat 1: eqmegz (button) folded before Flop (didn't bet)
Seat 2: Derelick7 (small blind) folded before Flop
Seat 3: Vlad0184 (big blind) folded before Flop
Seat 4: comeecome88 folded before Flop (didn't bet)
Seat 6: tuvshin777 folded before Flop (didn't bet)
Seat 7: crazysit folded before Flop (didn't bet)
Seat 8: ollikahn23 collected (2420)
Seat 9: 1JORSON folded on the Turn



PokerStars Hand #185453077164: Tournament #2282606587, $13.37+$1.63 USD Hold'em No Limit - Level VIII (100/200) - 2018/04/20 9:20:52 ET
Table '2282606587 6' 9-max Seat #2 is the button
Seat 1: eqmegz (2559 in chips) 
Seat 2: Derelick7 (2625 in chips) 
Seat 3: Vlad0184 (10025 in chips) 
Seat 4: comeecome88 (3254 in chips) 
Seat 5: arekadolf (3115 in chips) 
Seat 6: tuvshin777 (4277 in chips) 
Seat 7: crazysit (2835 in chips) 
Seat 8: ollikahn23 (6115 in chips) 
Seat 9: 1JORSON (2868 in chips) 
eqmegz: posts the ante 25
Derelick7: posts the ante 25
Vlad0184: posts the ante 25
comeecome88: posts the ante 25
arekadolf: posts the ante 25
tuvshin777: posts the ante 25
crazysit: posts the ante 25
ollikahn23: posts the ante 25
1JORSON: posts the ante 25
Vlad0184: posts small blind 100
comeecome88: posts big blind 200
*** HOLE CARDS ***
Dealt to ollikahn23 [2d 5d]
arekadolf: folds 
tuvshin777: folds 
crazysit: raises 2610 to 2810 and is all-in
ollikahn23: folds 
1JORSON: folds 
eqmegz: folds 
Derelick7: folds 
Vlad0184: folds 
comeecome88: calls 2610
*** FLOP *** [Qh 5h 8h]
*** TURN *** [Qh 5h 8h] [9d]
*** RIVER *** [Qh 5h 8h 9d] [5c]
*** SHOW DOWN ***
comeecome88: shows [6h 6d] (two pair, Sixes and Fives)
crazysit: shows [Ad Kc] (a pair of Fives)
comeecome88 collected 5945 from pot
crazysit finished the tournament
*** SUMMARY ***
Total pot 5945 | Rake 0 
Board [Qh 5h 8h 9d 5c]
Seat 1: eqmegz folded before Flop (didn't bet)
Seat 2: Derelick7 (button) folded before Flop (didn't bet)
Seat 3: Vlad0184 (small blind) folded before Flop
Seat 4: comeecome88 (big blind) showed [6h 6d] and won (5945) with two pair, Sixes and Fives
Seat 5: arekadolf folded before Flop (didn't bet)
Seat 6: tuvshin777 folded before Flop (didn't bet)
Seat 7: crazysit showed [Ad Kc] and lost with a pair of Fives
Seat 8: ollikahn23 folded before Flop (didn't bet)
Seat 9: 1JORSON folded before Flop (didn't bet)



PokerStars Hand #185453093479: Tournament #2282606587, $13.37+$1.63 USD Hold'em No Limit - Level VIII (100/200) - 2018/04/20 9:21:27 ET
Table '2282606587 6' 9-max Seat #3 is the button
Seat 1: eqmegz (2534 in chips) 
Seat 2: Derelick7 (2600 in chips) 
Seat 3: Vlad0184 (9900 in chips) 
Seat 4: comeecome88 (6364 in chips) 
Seat 5: arekadolf (3090 in chips) 
Seat 6: tuvshin777 (4252 in chips) 
Seat 8: ollikahn23 (6090 in chips) 
Seat 9: 1JORSON (2843 in chips) 
eqmegz: posts the ante 25
Derelick7: posts the ante 25
Vlad0184: posts the ante 25
comeecome88: posts the ante 25
arekadolf: posts the ante 25
tuvshin777: posts the ante 25
ollikahn23: posts the ante 25
1JORSON: posts the ante 25
comeecome88: posts small blind 100
arekadolf: posts big blind 200
*** HOLE CARDS ***
Dealt to ollikahn23 [4d 2d]
tuvshin777: raises 200 to 400
ollikahn23: folds 
1JORSON: folds 
eqmegz: folds 
Derelick7: folds 
Vlad0184: folds 
comeecome88: folds 
arekadolf: folds 
Uncalled bet (200) returned to tuvshin777
tuvshin777 collected 700 from pot
tuvshin777: doesn't show hand 
*** SUMMARY ***
Total pot 700 | Rake 0 
Seat 1: eqmegz folded before Flop (didn't bet)
Seat 2: Derelick7 folded before Flop (didn't bet)
Seat 3: Vlad0184 (button) folded before Flop (didn't bet)
Seat 4: comeecome88 (small blind) folded before Flop
Seat 5: arekadolf (big blind) folded before Flop
Seat 6: tuvshin777 collected (700)
Seat 8: ollikahn23 folded before Flop (didn't bet)
Seat 9: 1JORSON folded before Flop (didn't bet)



PokerStars Hand #185453102052: Tournament #2282606587, $13.37+$1.63 USD Hold'em No Limit - Level VIII (100/200) - 2018/04/20 9:21:45 ET
Table '2282606587 6' 9-max Seat #4 is the button
Seat 1: eqmegz (2509 in chips) 
Seat 2: Derelick7 (2575 in chips) 
Seat 3: Vlad0184 (9875 in chips) 
Seat 4: comeecome88 (6239 in chips) 
Seat 5: arekadolf (2865 in chips) 
Seat 6: tuvshin777 (4727 in chips) 
Seat 8: ollikahn23 (6065 in chips) 
Seat 9: 1JORSON (2818 in chips) 
eqmegz: posts the ante 25
Derelick7: posts the ante 25
Vlad0184: posts the ante 25
comeecome88: posts the ante 25
arekadolf: posts the ante 25
tuvshin777: posts the ante 25
ollikahn23: posts the ante 25
1JORSON: posts the ante 25
arekadolf: posts small blind 100
tuvshin777: posts big blind 200
*** HOLE CARDS ***
Dealt to ollikahn23 [Qs 6s]
ollikahn23: folds 
1JORSON: folds 
eqmegz: folds 
Derelick7: folds 
Vlad0184: folds 
comeecome88: folds 
arekadolf: raises 2640 to 2840 and is all-in
tuvshin777: folds 
Uncalled bet (2640) returned to arekadolf
arekadolf collected 600 from pot
arekadolf: doesn't show hand 
*** SUMMARY ***
Total pot 600 | Rake 0 
Seat 1: eqmegz folded before Flop (didn't bet)
Seat 2: Derelick7 folded before Flop (didn't bet)
Seat 3: Vlad0184 folded before Flop (didn't bet)
Seat 4: comeecome88 (button) folded before Flop (didn't bet)
Seat 5: arekadolf (small blind) collected (600)
Seat 6: tuvshin777 (big blind) folded before Flop
Seat 8: ollikahn23 folded before Flop (didn't bet)
Seat 9: 1JORSON folded before Flop (didn't bet)



PokerStars Hand #185453110902: Tournament #2282606587, $13.37+$1.63 USD Hold'em No Limit - Level VIII (100/200) - 2018/04/20 9:22:04 ET
Table '2282606587 6' 9-max Seat #5 is the button
Seat 1: eqmegz (2484 in chips) 
Seat 2: Derelick7 (2550 in chips) 
Seat 3: Vlad0184 (9850 in chips) 
Seat 4: comeecome88 (6214 in chips) 
Seat 5: arekadolf (3240 in chips) 
Seat 6: tuvshin777 (4502 in chips) 
Seat 8: ollikahn23 (6040 in chips) 
Seat 9: 1JORSON (2793 in chips) 
eqmegz: posts the ante 25
Derelick7: posts the ante 25
Vlad0184: posts the ante 25
comeecome88: posts the ante 25
arekadolf: posts the ante 25
tuvshin777: posts the ante 25
ollikahn23: posts the ante 25
1JORSON: posts the ante 25
tuvshin777: posts small blind 100
ollikahn23: posts big blind 200
*** HOLE CARDS ***
Dealt to ollikahn23 [Kc Jh]
1JORSON: folds 
eqmegz: folds 
Derelick7: raises 2325 to 2525 and is all-in
Vlad0184: calls 2525
comeecome88: folds 
arekadolf: folds 
tuvshin777: folds 
ollikahn23: folds 
*** FLOP *** [4d Ad 2c]
*** TURN *** [4d Ad 2c] [2d]
*** RIVER *** [4d Ad 2c 2d] [Js]
*** SHOW DOWN ***
Derelick7: shows [8c 6c] (a pair of Deuces)
Vlad0184: shows [Kh Ks] (two pair, Kings and Deuces)
Vlad0184 collected 5550 from pot
Derelick7 finished the tournament
*** SUMMARY ***
Total pot 5550 | Rake 0 
Board [4d Ad 2c 2d Js]
Seat 1: eqmegz folded before Flop (didn't bet)
Seat 2: Derelick7 showed [8c 6c] and lost with a pair of Deuces
Seat 3: Vlad0184 showed [Kh Ks] and won (5550) with two pair, Kings and Deuces
Seat 4: comeecome88 folded before Flop (didn't bet)
Seat 5: arekadolf (button) folded before Flop (didn't bet)
Seat 6: tuvshin777 (small blind) folded before Flop
Seat 8: ollikahn23 (big blind) folded before Flop
Seat 9: 1JORSON folded before Flop (didn't bet)



PokerStars Hand #185453130404: Tournament #2282606587, $13.37+$1.63 USD Hold'em No Limit - Level VIII (100/200) - 2018/04/20 9:22:44 ET
Table '2282606587 6' 9-max Seat #6 is the button
Seat 1: eqmegz (2459 in chips) 
Seat 3: Vlad0184 (12850 in chips) 
Seat 4: comeecome88 (6189 in chips) 
Seat 5: arekadolf (3215 in chips) 
Seat 6: tuvshin777 (4377 in chips) 
Seat 8: ollikahn23 (5815 in chips) 
Seat 9: 1JORSON (2768 in chips) 
eqmegz: posts the ante 25
Vlad0184: posts the ante 25
comeecome88: posts the ante 25
arekadolf: posts the ante 25
tuvshin777: posts the ante 25
ollikahn23: posts the ante 25
1JORSON: posts the ante 25
ollikahn23: posts small blind 100
1JORSON: posts big blind 200
*** HOLE CARDS ***
Dealt to ollikahn23 [3h Jd]
eqmegz: folds 
Vlad0184: folds 
comeecome88: folds 
arekadolf: folds 
tuvshin777: folds 
ollikahn23: folds 
Uncalled bet (100) returned to 1JORSON
1JORSON collected 375 from pot
1JORSON: doesn't show hand 
*** SUMMARY ***
Total pot 375 | Rake 0 
Seat 1: eqmegz folded before Flop (didn't bet)
Seat 3: Vlad0184 folded before Flop (didn't bet)
Seat 4: comeecome88 folded before Flop (didn't bet)
Seat 5: arekadolf folded before Flop (didn't bet)
Seat 6: tuvshin777 (button) folded before Flop (didn't bet)
Seat 8: ollikahn23 (small blind) folded before Flop
Seat 9: 1JORSON (big blind) collected (375)



PokerStars Hand #185453143446: Tournament #2282606587, $13.37+$1.63 USD Hold'em No Limit - Level VIII (100/200) - 2018/04/20 9:23:12 ET
Table '2282606587 6' 9-max Seat #8 is the button
Seat 1: eqmegz (2434 in chips) 
Seat 2: LMayi (15345 in chips) 
Seat 3: Vlad0184 (12825 in chips) 
Seat 4: comeecome88 (6164 in chips) 
Seat 5: arekadolf (3190 in chips) 
Seat 6: tuvshin777 (4352 in chips) 
Seat 7: Derelick7 (3000 in chips) 
Seat 8: ollikahn23 (5690 in chips) 
Seat 9: 1JORSON (3018 in chips) 
eqmegz: posts the ante 25
LMayi: posts the ante 25
Vlad0184: posts the ante 25
comeecome88: posts the ante 25
arekadolf: posts the ante 25
tuvshin777: posts the ante 25
Derelick7: posts the ante 25
ollikahn23: posts the ante 25
1JORSON: posts the ante 25
1JORSON: posts small blind 100
eqmegz: posts big blind 200
*** HOLE CARDS ***
Dealt to ollikahn23 [7c 8c]
LMayi: folds 
Vlad0184 has timed out
Vlad0184: folds 
Vlad0184 is sitting out
comeecome88: folds 
arekadolf: folds 
tuvshin777: folds 
Derelick7: folds 
ollikahn23: folds 
1JORSON: calls 100
eqmegz: checks 
*** FLOP *** [2c 7h 9s]
1JORSON: checks 
eqmegz: checks 
*** TURN *** [2c 7h 9s] [Jc]
Vlad0184 has returned
1JORSON: bets 200
eqmegz: folds 
Uncalled bet (200) returned to 1JORSON
1JORSON collected 625 from pot
1JORSON: doesn't show hand 
*** SUMMARY ***
Total pot 625 | Rake 0 
Board [2c 7h 9s Jc]
Seat 1: eqmegz (big blind) folded on the Turn
Seat 2: LMayi folded before Flop (didn't bet)
Seat 3: Vlad0184 folded before Flop (didn't bet)
Seat 4: comeecome88 folded before Flop (didn't bet)
Seat 5: arekadolf folded before Flop (didn't bet)
Seat 6: tuvshin777 folded before Flop (didn't bet)
Seat 7: Derelick7 folded before Flop (didn't bet)
Seat 8: ollikahn23 (button) folded before Flop (didn't bet)
Seat 9: 1JORSON (small blind) collected (625)



PokerStars Hand #185453179999: Tournament #2282606587, $13.37+$1.63 USD Hold'em No Limit - Level VIII (100/200) - 2018/04/20 9:24:28 ET
Table '2282606587 6' 9-max Seat #9 is the button
Seat 1: eqmegz (2209 in chips) 
Seat 3: Vlad0184 (12800 in chips) 
Seat 4: comeecome88 (6139 in chips) 
Seat 5: arekadolf (3165 in chips) 
Seat 6: tuvshin777 (4327 in chips) 
Seat 7: Derelick7 (2975 in chips) 
Seat 8: ollikahn23 (5665 in chips) 
Seat 9: 1JORSON (3418 in chips) 
eqmegz: posts the ante 25
Vlad0184: posts the ante 25
comeecome88: posts the ante 25
arekadolf: posts the ante 25
tuvshin777: posts the ante 25
Derelick7: posts the ante 25
ollikahn23: posts the ante 25
1JORSON: posts the ante 25
eqmegz: posts small blind 100
Vlad0184: posts big blind 200
*** HOLE CARDS ***
Dealt to ollikahn23 [As 3c]
comeecome88: folds 
arekadolf: folds 
tuvshin777: folds 
Derelick7: folds 
ollikahn23: raises 222 to 422
1JORSON: calls 422
eqmegz: raises 1762 to 2184 and is all-in
Vlad0184: folds 
ollikahn23: folds 
1JORSON: folds 
Uncalled bet (1762) returned to eqmegz
eqmegz collected 1666 from pot
*** SUMMARY ***
Total pot 1666 | Rake 0 
Seat 1: eqmegz (small blind) collected (1666)
Seat 3: Vlad0184 (big blind) folded before Flop
Seat 4: comeecome88 folded before Flop (didn't bet)
Seat 5: arekadolf folded before Flop (didn't bet)
Seat 6: tuvshin777 folded before Flop (didn't bet)
Seat 7: Derelick7 folded before Flop (didn't bet)
Seat 8: ollikahn23 folded before Flop
Seat 9: 1JORSON (button) folded before Flop



PokerStars Hand #185453207303: Tournament #2282606587, $13.37+$1.63 USD Hold'em No Limit - Level VIII (100/200) - 2018/04/20 9:25:26 ET
Table '2282606587 6' 9-max Seat #1 is the button
Seat 1: eqmegz (3428 in chips) 
Seat 3: Vlad0184 (12575 in chips) 
Seat 4: comeecome88 (6114 in chips) 
Seat 5: arekadolf (3140 in chips) 
Seat 6: tuvshin777 (4302 in chips) 
Seat 7: Derelick7 (2950 in chips) 
Seat 8: ollikahn23 (5218 in chips) 
Seat 9: 1JORSON (2971 in chips) 
eqmegz: posts the ante 25
Vlad0184: posts the ante 25
comeecome88: posts the ante 25
arekadolf: posts the ante 25
tuvshin777: posts the ante 25
Derelick7: posts the ante 25
ollikahn23: posts the ante 25
1JORSON: posts the ante 25
Vlad0184: posts small blind 100
comeecome88: posts big blind 200
*** HOLE CARDS ***
Dealt to ollikahn23 [5h Qs]
arekadolf: folds 
tuvshin777: folds 
Derelick7: folds 
ollikahn23: folds 
1JORSON: raises 2746 to 2946 and is all-in
eqmegz: folds 
Vlad0184: folds 
comeecome88: folds 
Uncalled bet (2746) returned to 1JORSON
1JORSON collected 700 from pot
1JORSON: doesn't show hand 
*** SUMMARY ***
Total pot 700 | Rake 0 
Seat 1: eqmegz (button) folded before Flop (didn't bet)
Seat 3: Vlad0184 (small blind) folded before Flop
Seat 4: comeecome88 (big blind) folded before Flop
Seat 5: arekadolf folded before Flop (didn't bet)
Seat 6: tuvshin777 folded before Flop (didn't bet)
Seat 7: Derelick7 folded before Flop (didn't bet)
Seat 8: ollikahn23 folded before Flop (didn't bet)
Seat 9: 1JORSON collected (700)



PokerStars Hand #185453215850: Tournament #2282606587, $13.37+$1.63 USD Hold'em No Limit - Level VIII (100/200) - 2018/04/20 9:25:44 ET
Table '2282606587 6' 9-max Seat #3 is the button
Seat 1: eqmegz (3403 in chips) 
Seat 3: Vlad0184 (12450 in chips) 
Seat 4: comeecome88 (5889 in chips) 
Seat 5: arekadolf (3115 in chips) 
Seat 6: tuvshin777 (4277 in chips) 
Seat 7: Derelick7 (2925 in chips) 
Seat 8: ollikahn23 (5193 in chips) 
Seat 9: 1JORSON (3446 in chips) 
eqmegz: posts the ante 25
Vlad0184: posts the ante 25
comeecome88: posts the ante 25
arekadolf: posts the ante 25
tuvshin777: posts the ante 25
Derelick7: posts the ante 25
ollikahn23: posts the ante 25
1JORSON: posts the ante 25
comeecome88: posts small blind 100
arekadolf: posts big blind 200
*** HOLE CARDS ***
Dealt to ollikahn23 [2c Qs]
tuvshin777: folds 
Derelick7: raises 2700 to 2900 and is all-in
ollikahn23: folds 
1JORSON: folds 
eqmegz: folds 
Vlad0184: folds 
comeecome88: folds 
arekadolf: folds 
Uncalled bet (2700) returned to Derelick7
Derelick7 collected 700 from pot
Derelick7: doesn't show hand 
*** SUMMARY ***
Total pot 700 | Rake 0 
Seat 1: eqmegz folded before Flop (didn't bet)
Seat 3: Vlad0184 (button) folded before Flop (didn't bet)
Seat 4: comeecome88 (small blind) folded before Flop
Seat 5: arekadolf (big blind) folded before Flop
Seat 6: tuvshin777 folded before Flop (didn't bet)
Seat 7: Derelick7 collected (700)
Seat 8: ollikahn23 folded before Flop (didn't bet)
Seat 9: 1JORSON folded before Flop (didn't bet)



PokerStars Hand #185453225880: Tournament #2282606587, $13.37+$1.63 USD Hold'em No Limit - Level VIII (100/200) - 2018/04/20 9:26:05 ET
Table '2282606587 6' 9-max Seat #4 is the button
Seat 1: eqmegz (3378 in chips) 
Seat 3: Vlad0184 (12425 in chips) 
Seat 4: comeecome88 (5764 in chips) 
Seat 5: arekadolf (2890 in chips) 
Seat 6: tuvshin777 (4252 in chips) 
Seat 7: Derelick7 (3400 in chips) 
Seat 8: ollikahn23 (5168 in chips) 
Seat 9: 1JORSON (3421 in chips) 
eqmegz: posts the ante 25
Vlad0184: posts the ante 25
comeecome88: posts the ante 25
arekadolf: posts the ante 25
tuvshin777: posts the ante 25
Derelick7: posts the ante 25
ollikahn23: posts the ante 25
1JORSON: posts the ante 25
arekadolf: posts small blind 100
tuvshin777: posts big blind 200
*** HOLE CARDS ***
Dealt to ollikahn23 [3d 2s]
Derelick7: folds 
ollikahn23: folds 
1JORSON: folds 
eqmegz: raises 3153 to 3353 and is all-in
Vlad0184: folds 
comeecome88: folds 
arekadolf: folds 
tuvshin777: folds 
Uncalled bet (3153) returned to eqmegz
eqmegz collected 700 from pot
*** SUMMARY ***
Total pot 700 | Rake 0 
Seat 1: eqmegz collected (700)
Seat 3: Vlad0184 folded before Flop (didn't bet)
Seat 4: comeecome88 (button) folded before Flop (didn't bet)
Seat 5: arekadolf (small blind) folded before Flop
Seat 6: tuvshin777 (big blind) folded before Flop
Seat 7: Derelick7 folded before Flop (didn't bet)
Seat 8: ollikahn23 folded before Flop (didn't bet)
Seat 9: 1JORSON folded before Flop (didn't bet)



PokerStars Hand #185453238560: Tournament #2282606587, $13.37+$1.63 USD Hold'em No Limit - Level VIII (100/200) - 2018/04/20 9:26:32 ET
Table '2282606587 6' 9-max Seat #5 is the button
Seat 1: eqmegz (3853 in chips) 
Seat 3: Vlad0184 (12400 in chips) 
Seat 4: comeecome88 (5739 in chips) 
Seat 5: arekadolf (2765 in chips) 
Seat 6: tuvshin777 (4027 in chips) 
Seat 7: Derelick7 (3375 in chips) 
Seat 8: ollikahn23 (5143 in chips) 
Seat 9: 1JORSON (3396 in chips) 
eqmegz: posts the ante 25
Vlad0184: posts the ante 25
comeecome88: posts the ante 25
arekadolf: posts the ante 25
tuvshin777: posts the ante 25
Derelick7: posts the ante 25
ollikahn23: posts the ante 25
1JORSON: posts the ante 25
tuvshin777: posts small blind 100
Derelick7: posts big blind 200
*** HOLE CARDS ***
Dealt to ollikahn23 [8d Qd]
ollikahn23: folds 
1JORSON: folds 
eqmegz: folds 
Vlad0184: folds 
comeecome88: raises 200 to 400
arekadolf: raises 2340 to 2740 and is all-in
tuvshin777: folds 
Derelick7: folds 
comeecome88: folds 
Uncalled bet (2340) returned to arekadolf
arekadolf collected 1300 from pot
arekadolf: doesn't show hand 
*** SUMMARY ***
Total pot 1300 | Rake 0 
Seat 1: eqmegz folded before Flop (didn't bet)
Seat 3: Vlad0184 folded before Flop (didn't bet)
Seat 4: comeecome88 folded before Flop
Seat 5: arekadolf (button) collected (1300)
Seat 6: tuvshin777 (small blind) folded before Flop
Seat 7: Derelick7 (big blind) folded before Flop
Seat 8: ollikahn23 folded before Flop (didn't bet)
Seat 9: 1JORSON folded before Flop (didn't bet)



PokerStars Hand #185453248144: Tournament #2282606587, $13.37+$1.63 USD Hold'em No Limit - Level VIII (100/200) - 2018/04/20 9:26:53 ET
Table '2282606587 6' 9-max Seat #6 is the button
Seat 1: eqmegz (3828 in chips) 
Seat 2: 18nina18 (3000 in chips) 
Seat 3: Vlad0184 (12375 in chips) 
Seat 4: comeecome88 (5314 in chips) 
Seat 5: arekadolf (3640 in chips) 
Seat 6: tuvshin777 (3902 in chips) 
Seat 7: Derelick7 (3150 in chips) 
Seat 8: ollikahn23 (5118 in chips) 
Seat 9: 1JORSON (3371 in chips) 
eqmegz: posts the ante 25
18nina18: posts the ante 25
Vlad0184: posts the ante 25
comeecome88: posts the ante 25
arekadolf: posts the ante 25
tuvshin777: posts the ante 25
Derelick7: posts the ante 25
ollikahn23: posts the ante 25
1JORSON: posts the ante 25
Derelick7: posts small blind 100
ollikahn23: posts big blind 200
*** HOLE CARDS ***
Dealt to ollikahn23 [5c 4d]
1JORSON: folds 
eqmegz: folds 
18nina18: folds 
Vlad0184: folds 
comeecome88: folds 
arekadolf: raises 200 to 400
tuvshin777: calls 400
Derelick7: folds 
ollikahn23: calls 200
*** FLOP *** [2h 9d 2s]
ollikahn23: checks 
arekadolf: checks 
tuvshin777: checks 
*** TURN *** [2h 9d 2s] [9c]
ollikahn23: bets 525
arekadolf: folds 
tuvshin777: folds 
Uncalled bet (525) returned to ollikahn23
ollikahn23 collected 1525 from pot
ollikahn23: doesn't show hand 
*** SUMMARY ***
Total pot 1525 | Rake 0 
Board [2h 9d 2s 9c]
Seat 1: eqmegz folded before Flop (didn't bet)
Seat 2: 18nina18 folded before Flop (didn't bet)
Seat 3: Vlad0184 folded before Flop (didn't bet)
Seat 4: comeecome88 folded before Flop (didn't bet)
Seat 5: arekadolf folded on the Turn
Seat 6: tuvshin777 (button) folded on the Turn
Seat 7: Derelick7 (small blind) folded before Flop
Seat 8: ollikahn23 (big blind) collected (1525)
Seat 9: 1JORSON folded before Flop (didn't bet)



PokerStars Hand #185453273176: Tournament #2282606587, $13.37+$1.63 USD Hold'em No Limit - Level VIII (100/200) - 2018/04/20 9:27:46 ET
Table '2282606587 6' 9-max Seat #7 is the button
Seat 2: 18nina18 (2975 in chips) 
Seat 3: Vlad0184 (12350 in chips) 
Seat 4: comeecome88 (5289 in chips) 
Seat 5: arekadolf (3215 in chips) 
Seat 6: tuvshin777 (3477 in chips) 
Seat 7: Derelick7 (3025 in chips) 
Seat 8: ollikahn23 (6218 in chips) 
Seat 9: 1JORSON (3346 in chips) 
18nina18: posts the ante 25
Vlad0184: posts the ante 25
comeecome88: posts the ante 25
arekadolf: posts the ante 25
tuvshin777: posts the ante 25
Derelick7: posts the ante 25
ollikahn23: posts the ante 25
1JORSON: posts the ante 25
ollikahn23: posts small blind 100
1JORSON: posts big blind 200
*** HOLE CARDS ***
Dealt to ollikahn23 [7d 5d]
18nina18: folds 
Vlad0184: folds 
comeecome88: folds 
arekadolf: folds 
tuvshin777: raises 200 to 400
Derelick7: folds 
ollikahn23: folds 
1JORSON: calls 200
*** FLOP *** [5c Ts 3d]
1JORSON: checks 
tuvshin777: checks 
*** TURN *** [5c Ts 3d] [5h]
1JORSON: bets 550
tuvshin777: calls 550
*** RIVER *** [5c Ts 3d 5h] [6c]
1JORSON: checks 
tuvshin777: checks 
*** SHOW DOWN ***
1JORSON: shows [Td 8d] (two pair, Tens and Fives)
tuvshin777: mucks hand 
1JORSON collected 2200 from pot
*** SUMMARY ***
Total pot 2200 | Rake 0 
Board [5c Ts 3d 5h 6c]
Seat 2: 18nina18 folded before Flop (didn't bet)
Seat 3: Vlad0184 folded before Flop (didn't bet)
Seat 4: comeecome88 folded before Flop (didn't bet)
Seat 5: arekadolf folded before Flop (didn't bet)
Seat 6: tuvshin777 mucked [Ac Jc]
Seat 7: Derelick7 (button) folded before Flop (didn't bet)
Seat 8: ollikahn23 (small blind) folded before Flop
Seat 9: 1JORSON (big blind) showed [Td 8d] and won (2200) with two pair, Tens and Fives



PokerStars Hand #185453312025: Tournament #2282606587, $13.37+$1.63 USD Hold'em No Limit - Level IX (125/250) - 2018/04/20 9:29:08 ET
Table '2282606587 6' 9-max Seat #8 is the button
Seat 1: NightG214 (2840 in chips) 
Seat 2: 18nina18 (2950 in chips) 
Seat 3: Vlad0184 (12325 in chips) 
Seat 4: comeecome88 (5264 in chips) 
Seat 5: arekadolf (3190 in chips) 
Seat 6: tuvshin777 (2502 in chips) 
Seat 7: Derelick7 (3000 in chips) 
Seat 8: ollikahn23 (6093 in chips) 
Seat 9: 1JORSON (4571 in chips) 
NightG214: posts the ante 30
18nina18: posts the ante 30
Vlad0184: posts the ante 30
comeecome88: posts the ante 30
arekadolf: posts the ante 30
tuvshin777: posts the ante 30
Derelick7: posts the ante 30
ollikahn23: posts the ante 30
1JORSON: posts the ante 30
1JORSON: posts small blind 125
NightG214: posts big blind 250
*** HOLE CARDS ***
Dealt to ollikahn23 [Qc Kd]
18nina18: folds 
Vlad0184: folds 
comeecome88: folds 
arekadolf: folds 
tuvshin777: folds 
Derelick7: folds 
ollikahn23: raises 5813 to 6063 and is all-in
1JORSON: folds 
NightG214: folds 
Uncalled bet (5813) returned to ollikahn23
ollikahn23 collected 895 from pot
ollikahn23: doesn't show hand 
*** SUMMARY ***
Total pot 895 | Rake 0 
Seat 1: NightG214 (big blind) folded before Flop
Seat 2: 18nina18 folded before Flop (didn't bet)
Seat 3: Vlad0184 folded before Flop (didn't bet)
Seat 4: comeecome88 folded before Flop (didn't bet)
Seat 5: arekadolf folded before Flop (didn't bet)
Seat 6: tuvshin777 folded before Flop (didn't bet)
Seat 7: Derelick7 folded before Flop (didn't bet)
Seat 8: ollikahn23 (button) collected (895)
Seat 9: 1JORSON (small blind) folded before Flop



PokerStars Hand #185453332256: Tournament #2282606587, $13.37+$1.63 USD Hold'em No Limit - Level IX (125/250) - 2018/04/20 9:29:52 ET
Table '2282606587 6' 9-max Seat #9 is the button
Seat 1: NightG214 (2560 in chips) 
Seat 2: 18nina18 (2920 in chips) 
Seat 3: Vlad0184 (12295 in chips) 
Seat 4: comeecome88 (5234 in chips) 
Seat 5: arekadolf (3160 in chips) 
Seat 6: tuvshin777 (2472 in chips) 
Seat 8: ollikahn23 (6708 in chips) 
Seat 9: 1JORSON (4416 in chips) 
NightG214: posts the ante 30
18nina18: posts the ante 30
Vlad0184: posts the ante 30
comeecome88: posts the ante 30
arekadolf: posts the ante 30
tuvshin777: posts the ante 30
ollikahn23: posts the ante 30
1JORSON: posts the ante 30
NightG214: posts small blind 125
18nina18: posts big blind 250
*** HOLE CARDS ***
Dealt to ollikahn23 [Qd Jh]
Vlad0184: folds 
comeecome88: folds 
arekadolf: folds 
tuvshin777: folds 
ollikahn23: raises 255 to 505
1JORSON: calls 505
NightG214: folds 
18nina18: calls 255
*** FLOP *** [8s 7h 7s]
18nina18: checks 
ollikahn23: bets 757
1JORSON: folds 
18nina18: folds 
Uncalled bet (757) returned to ollikahn23
ollikahn23 collected 1880 from pot
ollikahn23: doesn't show hand 
*** SUMMARY ***
Total pot 1880 | Rake 0 
Board [8s 7h 7s]
Seat 1: NightG214 (small blind) folded before Flop
Seat 2: 18nina18 (big blind) folded on the Flop
Seat 3: Vlad0184 folded before Flop (didn't bet)
Seat 4: comeecome88 folded before Flop (didn't bet)
Seat 5: arekadolf folded before Flop (didn't bet)
Seat 6: tuvshin777 folded before Flop (didn't bet)
Seat 8: ollikahn23 collected (1880)
Seat 9: 1JORSON (button) folded on the Flop



PokerStars Hand #185453361084: Tournament #2282606587, $13.37+$1.63 USD Hold'em No Limit - Level IX (125/250) - 2018/04/20 9:30:53 ET
Table '2282606587 6' 9-max Seat #1 is the button
Seat 1: NightG214 (2405 in chips) 
Seat 2: 18nina18 (2385 in chips) 
Seat 3: Vlad0184 (12265 in chips) 
Seat 4: comeecome88 (5204 in chips) 
Seat 5: arekadolf (3130 in chips) 
Seat 6: tuvshin777 (2442 in chips) 
Seat 7: pukola (3000 in chips) 
Seat 8: ollikahn23 (8053 in chips) 
Seat 9: 1JORSON (3881 in chips) 
NightG214: posts the ante 30
18nina18: posts the ante 30
Vlad0184: posts the ante 30
comeecome88: posts the ante 30
arekadolf: posts the ante 30
tuvshin777: posts the ante 30
pukola: posts the ante 30
ollikahn23: posts the ante 30
1JORSON: posts the ante 30
18nina18: posts small blind 125
Vlad0184: posts big blind 250
*** HOLE CARDS ***
Dealt to ollikahn23 [2s Jc]
comeecome88: folds 
arekadolf: folds 
tuvshin777: folds 
pukola: folds 
ollikahn23: folds 
1JORSON: folds 
NightG214: folds 
18nina18: folds 
Uncalled bet (125) returned to Vlad0184
Vlad0184 collected 520 from pot
*** SUMMARY ***
Total pot 520 | Rake 0 
Seat 1: NightG214 (button) folded before Flop (didn't bet)
Seat 2: 18nina18 (small blind) folded before Flop
Seat 3: Vlad0184 (big blind) collected (520)
Seat 4: comeecome88 folded before Flop (didn't bet)
Seat 5: arekadolf folded before Flop (didn't bet)
Seat 6: tuvshin777 folded before Flop (didn't bet)
Seat 7: pukola folded before Flop (didn't bet)
Seat 8: ollikahn23 folded before Flop (didn't bet)
Seat 9: 1JORSON folded before Flop (didn't bet)



PokerStars Hand #185453371568: Tournament #2282606587, $13.37+$1.63 USD Hold'em No Limit - Level IX (125/250) - 2018/04/20 9:31:15 ET
Table '2282606587 6' 9-max Seat #2 is the button
Seat 1: NightG214 (2375 in chips) 
Seat 2: 18nina18 (2230 in chips) 
Seat 3: Vlad0184 (12630 in chips) 
Seat 4: comeecome88 (5174 in chips) 
Seat 5: arekadolf (3100 in chips) 
Seat 6: tuvshin777 (2412 in chips) 
Seat 7: pukola (2970 in chips) 
Seat 8: ollikahn23 (8023 in chips) 
Seat 9: 1JORSON (3851 in chips) 
NightG214: posts the ante 30
18nina18: posts the ante 30
Vlad0184: posts the ante 30
comeecome88: posts the ante 30
arekadolf: posts the ante 30
tuvshin777: posts the ante 30
pukola: posts the ante 30
ollikahn23: posts the ante 30
1JORSON: posts the ante 30
Vlad0184: posts small blind 125
comeecome88: posts big blind 250
*** HOLE CARDS ***
Dealt to ollikahn23 [8d 7h]
arekadolf: folds 
tuvshin777: folds 
pukola: folds 
ollikahn23: folds 
1JORSON: folds 
NightG214: raises 2095 to 2345 and is all-in
18nina18: folds 
Vlad0184: folds 
comeecome88: calls 2095
*** FLOP *** [Ad 6s 6c]
*** TURN *** [Ad 6s 6c] [4s]
*** RIVER *** [Ad 6s 6c 4s] [Kc]
*** SHOW DOWN ***
comeecome88: shows [Ah 9c] (two pair, Aces and Sixes)
NightG214: shows [Jh Td] (a pair of Sixes)
comeecome88 collected 5085 from pot
NightG214 finished the tournament
*** SUMMARY ***
Total pot 5085 | Rake 0 
Board [Ad 6s 6c 4s Kc]
Seat 1: NightG214 showed [Jh Td] and lost with a pair of Sixes
Seat 2: 18nina18 (button) folded before Flop (didn't bet)
Seat 3: Vlad0184 (small blind) folded before Flop
Seat 4: comeecome88 (big blind) showed [Ah 9c] and won (5085) with two pair, Aces and Sixes
Seat 5: arekadolf folded before Flop (didn't bet)
Seat 6: tuvshin777 folded before Flop (didn't bet)
Seat 7: pukola folded before Flop (didn't bet)
Seat 8: ollikahn23 folded before Flop (didn't bet)
Seat 9: 1JORSON folded before Flop (didn't bet)



PokerStars Hand #185453390390: Tournament #2282606587, $13.37+$1.63 USD Hold'em No Limit - Level IX (125/250) - 2018/04/20 9:31:55 ET
Table '2282606587 6' 9-max Seat #3 is the button
Seat 2: 18nina18 (2200 in chips) 
Seat 3: Vlad0184 (12475 in chips) 
Seat 4: comeecome88 (7884 in chips) 
Seat 5: arekadolf (3070 in chips) 
Seat 6: tuvshin777 (2382 in chips) 
Seat 7: pukola (2940 in chips) 
Seat 8: ollikahn23 (7993 in chips) 
Seat 9: 1JORSON (3821 in chips) 
18nina18: posts the ante 30
Vlad0184: posts the ante 30
comeecome88: posts the ante 30
arekadolf: posts the ante 30
tuvshin777: posts the ante 30
pukola: posts the ante 30
ollikahn23: posts the ante 30
1JORSON: posts the ante 30
comeecome88: posts small blind 125
arekadolf: posts big blind 250
*** HOLE CARDS ***
Dealt to ollikahn23 [6s Ac]
tuvshin777: folds 
pukola: folds 
ollikahn23: folds 
1JORSON: raises 3541 to 3791 and is all-in
18nina18: folds 
Vlad0184: folds 
comeecome88: folds 
arekadolf: folds 
Uncalled bet (3541) returned to 1JORSON
1JORSON collected 865 from pot
1JORSON: doesn't show hand 
*** SUMMARY ***
Total pot 865 | Rake 0 
Seat 2: 18nina18 folded before Flop (didn't bet)
Seat 3: Vlad0184 (button) folded before Flop (didn't bet)
Seat 4: comeecome88 (small blind) folded before Flop
Seat 5: arekadolf (big blind) folded before Flop
Seat 6: tuvshin777 folded before Flop (didn't bet)
Seat 7: pukola folded before Flop (didn't bet)
Seat 8: ollikahn23 folded before Flop (didn't bet)
Seat 9: 1JORSON collected (865)



PokerStars Hand #185453400699: Tournament #2282606587, $13.37+$1.63 USD Hold'em No Limit - Level IX (125/250) - 2018/04/20 9:32:17 ET
Table '2282606587 6' 9-max Seat #4 is the button
Seat 1: frost3ggg (10105 in chips) 
Seat 2: 18nina18 (2170 in chips) 
Seat 3: Vlad0184 (12445 in chips) 
Seat 4: comeecome88 (7729 in chips) 
Seat 5: arekadolf (2790 in chips) 
Seat 6: tuvshin777 (2352 in chips) 
Seat 7: pukola (2910 in chips) 
Seat 8: ollikahn23 (7963 in chips) 
Seat 9: 1JORSON (4406 in chips) 
frost3ggg: posts the ante 30
18nina18: posts the ante 30
Vlad0184: posts the ante 30
comeecome88: posts the ante 30
arekadolf: posts the ante 30
tuvshin777: posts the ante 30
pukola: posts the ante 30
ollikahn23: posts the ante 30
1JORSON: posts the ante 30
arekadolf: posts small blind 125
tuvshin777: posts big blind 250
*** HOLE CARDS ***
Dealt to ollikahn23 [8d 9d]
pukola: folds 
ollikahn23: folds 
1JORSON: folds 
frost3ggg: raises 250 to 500
18nina18: folds 
Vlad0184: folds 
comeecome88: folds 
arekadolf: raises 2260 to 2760 and is all-in
tuvshin777: folds 
frost3ggg: calls 2260
*** FLOP *** [5d 2h Qd]
*** TURN *** [5d 2h Qd] [Th]
*** RIVER *** [5d 2h Qd Th] [4s]
*** SHOW DOWN ***
arekadolf: shows [Js Ac] (high card Ace)
frost3ggg: shows [7c 7d] (a pair of Sevens)
frost3ggg collected 6040 from pot
arekadolf finished the tournament
*** SUMMARY ***
Total pot 6040 | Rake 0 
Board [5d 2h Qd Th 4s]
Seat 1: frost3ggg showed [7c 7d] and won (6040) with a pair of Sevens
Seat 2: 18nina18 folded before Flop (didn't bet)
Seat 3: Vlad0184 folded before Flop (didn't bet)
Seat 4: comeecome88 (button) folded before Flop (didn't bet)
Seat 5: arekadolf (small blind) showed [Js Ac] and lost with high card Ace
Seat 6: tuvshin777 (big blind) folded before Flop
Seat 7: pukola folded before Flop (didn't bet)
Seat 8: ollikahn23 folded before Flop (didn't bet)
Seat 9: 1JORSON folded before Flop (didn't bet)



PokerStars Hand #185453415713: Tournament #2282606587, $13.37+$1.63 USD Hold'em No Limit - Level IX (125/250) - 2018/04/20 9:32:48 ET
Table '2282606587 6' 9-max Seat #6 is the button
Seat 1: frost3ggg (13355 in chips) 
Seat 2: 18nina18 (2140 in chips) 
Seat 3: Vlad0184 (12415 in chips) 
Seat 4: comeecome88 (7699 in chips) 
Seat 6: tuvshin777 (2072 in chips) 
Seat 7: pukola (2880 in chips) 
Seat 8: ollikahn23 (7933 in chips) 
Seat 9: 1JORSON (4376 in chips) 
frost3ggg: posts the ante 30
18nina18: posts the ante 30
Vlad0184: posts the ante 30
comeecome88: posts the ante 30
tuvshin777: posts the ante 30
pukola: posts the ante 30
ollikahn23: posts the ante 30
1JORSON: posts the ante 30
pukola: posts small blind 125
ollikahn23: posts big blind 250
*** HOLE CARDS ***
Dealt to ollikahn23 [Jc 6s]
1JORSON: folds 
frost3ggg: folds 
18nina18: folds 
Vlad0184: folds 
comeecome88: folds 
tuvshin777: folds 
pukola: calls 125
ollikahn23: raises 305 to 555
pukola: folds 
Uncalled bet (305) returned to ollikahn23
ollikahn23 collected 740 from pot
ollikahn23: doesn't show hand 
*** SUMMARY ***
Total pot 740 | Rake 0 
Seat 1: frost3ggg folded before Flop (didn't bet)
Seat 2: 18nina18 folded before Flop (didn't bet)
Seat 3: Vlad0184 folded before Flop (didn't bet)
Seat 4: comeecome88 folded before Flop (didn't bet)
Seat 6: tuvshin777 (button) folded before Flop (didn't bet)
Seat 7: pukola (small blind) folded before Flop
Seat 8: ollikahn23 (big blind) collected (740)
Seat 9: 1JORSON folded before Flop (didn't bet)



PokerStars Hand #185453433624: Tournament #2282606587, $13.37+$1.63 USD Hold'em No Limit - Level IX (125/250) - 2018/04/20 9:33:27 ET
Table '2282606587 6' 9-max Seat #7 is the button
Seat 1: frost3ggg (13325 in chips) 
Seat 2: 18nina18 (2110 in chips) 
Seat 3: Vlad0184 (12385 in chips) 
Seat 4: comeecome88 (7669 in chips) 
Seat 5: alanzao (3000 in chips) 
Seat 6: tuvshin777 (2042 in chips) 
Seat 7: pukola (2600 in chips) 
Seat 8: ollikahn23 (8393 in chips) 
Seat 9: 1JORSON (4346 in chips) 
frost3ggg: posts the ante 30
18nina18: posts the ante 30
Vlad0184: posts the ante 30
comeecome88: posts the ante 30
alanzao: posts the ante 30
tuvshin777: posts the ante 30
pukola: posts the ante 30
ollikahn23: posts the ante 30
1JORSON: posts the ante 30
ollikahn23: posts small blind 125
1JORSON: posts big blind 250
*** HOLE CARDS ***
Dealt to ollikahn23 [9s 8h]
frost3ggg: folds 
18nina18: folds 
Vlad0184: calls 250
comeecome88: folds 
alanzao: folds 
tuvshin777: raises 250 to 500
pukola: folds 
ollikahn23: folds 
1JORSON: calls 250
Vlad0184: calls 250
*** FLOP *** [8s 2s 3s]
1JORSON: checks 
Vlad0184: bets 750
tuvshin777: raises 762 to 1512 and is all-in
1JORSON: folds 
Vlad0184: calls 762
*** TURN *** [8s 2s 3s] [Js]
*** RIVER *** [8s 2s 3s Js] [As]
*** SHOW DOWN ***
Vlad0184: shows [2d 2c] (a flush, Ace high)
tuvshin777: shows [Jc Jh] (a flush, Ace high)
Vlad0184 collected 2460 from pot
tuvshin777 collected 2459 from pot
*** SUMMARY ***
Total pot 4919 | Rake 0 
Board [8s 2s 3s Js As]
Seat 1: frost3ggg folded before Flop (didn't bet)
Seat 2: 18nina18 folded before Flop (didn't bet)
Seat 3: Vlad0184 showed [2d 2c] and won (2460) with a flush, Ace high
Seat 4: comeecome88 folded before Flop (didn't bet)
Seat 5: alanzao folded before Flop (didn't bet)
Seat 6: tuvshin777 showed [Jc Jh] and won (2459) with a flush, Ace high
Seat 7: pukola (button) folded before Flop (didn't bet)
Seat 8: ollikahn23 (small blind) folded before Flop
Seat 9: 1JORSON (big blind) folded on the Flop



PokerStars Hand #185453465930: Tournament #2282606587, $13.37+$1.63 USD Hold'em No Limit - Level IX (125/250) - 2018/04/20 9:34:24 ET
Table '2282606587 6' 9-max Seat #8 is the button
Seat 1: frost3ggg (13295 in chips) 
Seat 2: 18nina18 (2080 in chips) 
Seat 3: Vlad0184 (12803 in chips) 
Seat 4: comeecome88 (7639 in chips) 
Seat 5: alanzao (2970 in chips) 
Seat 6: tuvshin777 (2459 in chips) 
Seat 7: pukola (2570 in chips) 
Seat 8: ollikahn23 (8238 in chips) 
Seat 9: 1JORSON (3816 in chips) 
frost3ggg: posts the ante 30
18nina18: posts the ante 30
Vlad0184: posts the ante 30
comeecome88: posts the ante 30
alanzao: posts the ante 30
tuvshin777: posts the ante 30
pukola: posts the ante 30
ollikahn23: posts the ante 30
1JORSON: posts the ante 30
1JORSON: posts small blind 125
frost3ggg: posts big blind 250
*** HOLE CARDS ***
Dealt to ollikahn23 [6s 6c]
18nina18: folds 
Vlad0184: calls 250
comeecome88: raises 500 to 750
alanzao: folds 
tuvshin777: folds 
pukola: folds 
ollikahn23: calls 750
1JORSON: folds 
frost3ggg: folds 
Vlad0184: calls 500
*** FLOP *** [Jd Ah Js]
Vlad0184: checks 
comeecome88: checks 
ollikahn23: bets 950
Vlad0184: folds 
comeecome88: folds 
Uncalled bet (950) returned to ollikahn23
ollikahn23 collected 2895 from pot
ollikahn23: doesn't show hand 
*** SUMMARY ***
Total pot 2895 | Rake 0 
Board [Jd Ah Js]
Seat 1: frost3ggg (big blind) folded before Flop
Seat 2: 18nina18 folded before Flop (didn't bet)
Seat 3: Vlad0184 folded on the Flop
Seat 4: comeecome88 folded on the Flop
Seat 5: alanzao folded before Flop (didn't bet)
Seat 6: tuvshin777 folded before Flop (didn't bet)
Seat 7: pukola folded before Flop (didn't bet)
Seat 8: ollikahn23 (button) collected (2895)
Seat 9: 1JORSON (small blind) folded before Flop



PokerStars Hand #185453487202: Tournament #2282606587, $13.37+$1.63 USD Hold'em No Limit - Level IX (125/250) - 2018/04/20 9:35:09 ET
Table '2282606587 6' 9-max Seat #9 is the button
Seat 1: frost3ggg (13015 in chips) 
Seat 2: 18nina18 (2050 in chips) 
Seat 3: Vlad0184 (12023 in chips) 
Seat 4: comeecome88 (6859 in chips) 
Seat 5: alanzao (2940 in chips) 
Seat 6: tuvshin777 (2429 in chips) 
Seat 7: pukola (2540 in chips) 
Seat 8: ollikahn23 (10353 in chips) 
Seat 9: 1JORSON (3661 in chips) 
frost3ggg: posts the ante 30
18nina18: posts the ante 30
Vlad0184: posts the ante 30
comeecome88: posts the ante 30
alanzao: posts the ante 30
tuvshin777: posts the ante 30
pukola: posts the ante 30
ollikahn23: posts the ante 30
1JORSON: posts the ante 30
frost3ggg: posts small blind 125
18nina18: posts big blind 250
*** HOLE CARDS ***
Dealt to ollikahn23 [Kh 8c]
Vlad0184: folds 
comeecome88: raises 250 to 500
alanzao: folds 
tuvshin777: folds 
pukola: folds 
ollikahn23: folds 
1JORSON: folds 
frost3ggg: folds 
18nina18: calls 250
*** FLOP *** [7h 2d Th]
18nina18: checks 
comeecome88: checks 
*** TURN *** [7h 2d Th] [3h]
18nina18: checks 
comeecome88: checks 
*** RIVER *** [7h 2d Th 3h] [As]
18nina18: checks 
comeecome88: bets 6329 and is all-in
18nina18: folds 
Uncalled bet (6329) returned to comeecome88
comeecome88 collected 1395 from pot
*** SUMMARY ***
Total pot 1395 | Rake 0 
Board [7h 2d Th 3h As]
Seat 1: frost3ggg (small blind) folded before Flop
Seat 2: 18nina18 (big blind) folded on the River
Seat 3: Vlad0184 folded before Flop (didn't bet)
Seat 4: comeecome88 collected (1395)
Seat 5: alanzao folded before Flop (didn't bet)
Seat 6: tuvshin777 folded before Flop (didn't bet)
Seat 7: pukola folded before Flop (didn't bet)
Seat 8: ollikahn23 folded before Flop (didn't bet)
Seat 9: 1JORSON (button) folded before Flop (didn't bet)



PokerStars Hand #185453524736: Tournament #2282606587, $13.37+$1.63 USD Hold'em No Limit - Level IX (125/250) - 2018/04/20 9:36:30 ET
Table '2282606587 6' 9-max Seat #1 is the button
Seat 1: frost3ggg (12860 in chips) 
Seat 2: 18nina18 (1520 in chips) 
Seat 3: Vlad0184 (11993 in chips) 
Seat 4: comeecome88 (7724 in chips) 
Seat 5: alanzao (2910 in chips) 
Seat 6: tuvshin777 (2399 in chips) 
Seat 7: pukola (2510 in chips) 
Seat 8: ollikahn23 (10323 in chips) 
Seat 9: 1JORSON (3631 in chips) 
frost3ggg: posts the ante 30
18nina18: posts the ante 30
Vlad0184: posts the ante 30
comeecome88: posts the ante 30
alanzao: posts the ante 30
tuvshin777: posts the ante 30
pukola: posts the ante 30
ollikahn23: posts the ante 30
1JORSON: posts the ante 30
18nina18: posts small blind 125
Vlad0184: posts big blind 250
*** HOLE CARDS ***
Dealt to ollikahn23 [Ks 6c]
comeecome88: folds 
alanzao: folds 
tuvshin777: folds 
pukola: raises 2230 to 2480 and is all-in
ollikahn23: folds 
1JORSON: folds 
frost3ggg: folds 
18nina18: folds 
Vlad0184: folds 
Uncalled bet (2230) returned to pukola
pukola collected 895 from pot
pukola: doesn't show hand 
*** SUMMARY ***
Total pot 895 | Rake 0 
Seat 1: frost3ggg (button) folded before Flop (didn't bet)
Seat 2: 18nina18 (small blind) folded before Flop
Seat 3: Vlad0184 (big blind) folded before Flop
Seat 4: comeecome88 folded before Flop (didn't bet)
Seat 5: alanzao folded before Flop (didn't bet)
Seat 6: tuvshin777 folded before Flop (didn't bet)
Seat 7: pukola collected (895)
Seat 8: ollikahn23 folded before Flop (didn't bet)
Seat 9: 1JORSON folded before Flop (didn't bet)



PokerStars Hand #185453534119: Tournament #2282606587, $13.37+$1.63 USD Hold'em No Limit - Level IX (125/250) - 2018/04/20 9:36:50 ET
Table '2282606587 6' 9-max Seat #2 is the button
Seat 1: frost3ggg (12830 in chips) 
Seat 2: 18nina18 (1365 in chips) 
Seat 3: Vlad0184 (11713 in chips) 
Seat 4: comeecome88 (7694 in chips) 
Seat 5: alanzao (2880 in chips) 
Seat 6: tuvshin777 (2369 in chips) 
Seat 7: pukola (3125 in chips) 
Seat 8: ollikahn23 (10293 in chips) 
frost3ggg: posts the ante 30
18nina18: posts the ante 30
Vlad0184: posts the ante 30
comeecome88: posts the ante 30
alanzao: posts the ante 30
tuvshin777: posts the ante 30
pukola: posts the ante 30
ollikahn23: posts the ante 30
Vlad0184: posts small blind 125
comeecome88: posts big blind 250
*** HOLE CARDS ***
Dealt to ollikahn23 [9s Th]
alanzao: folds 
tuvshin777: folds 
pukola: folds 
ollikahn23: folds 
frost3ggg: folds 
18nina18: folds 
Vlad0184: folds 
Uncalled bet (125) returned to comeecome88
comeecome88 collected 490 from pot
*** SUMMARY ***
Total pot 490 | Rake 0 
Seat 1: frost3ggg folded before Flop (didn't bet)
Seat 2: 18nina18 (button) folded before Flop (didn't bet)
Seat 3: Vlad0184 (small blind) folded before Flop
Seat 4: comeecome88 (big blind) collected (490)
Seat 5: alanzao folded before Flop (didn't bet)
Seat 6: tuvshin777 folded before Flop (didn't bet)
Seat 7: pukola folded before Flop (didn't bet)
Seat 8: ollikahn23 folded before Flop (didn't bet)



PokerStars Hand #185453550393: Tournament #2282606587, $13.37+$1.63 USD Hold'em No Limit - Level IX (125/250) - 2018/04/20 9:37:25 ET
Table '2282606587 6' 9-max Seat #3 is the button
Seat 1: frost3ggg (12800 in chips) 
Seat 2: 18nina18 (1335 in chips) 
Seat 3: Vlad0184 (11558 in chips) 
Seat 4: comeecome88 (8029 in chips) 
Seat 5: alanzao (2850 in chips) 
Seat 6: tuvshin777 (2339 in chips) 
Seat 7: pukola (3095 in chips) 
Seat 8: ollikahn23 (10263 in chips) 
frost3ggg: posts the ante 30
18nina18: posts the ante 30
Vlad0184: posts the ante 30
comeecome88: posts the ante 30
alanzao: posts the ante 30
tuvshin777: posts the ante 30
pukola: posts the ante 30
ollikahn23: posts the ante 30
comeecome88: posts small blind 125
alanzao: posts big blind 250
*** HOLE CARDS ***
Dealt to ollikahn23 [4c 6d]
tuvshin777: folds 
pukola: folds 
ollikahn23: folds 
frost3ggg: folds 
18nina18: raises 1055 to 1305 and is all-in
Vlad0184: folds 
comeecome88: folds 
alanzao: calls 1055
*** FLOP *** [7c Ad 3h]
*** TURN *** [7c Ad 3h] [Ks]
*** RIVER *** [7c Ad 3h Ks] [2s]
*** SHOW DOWN ***
alanzao: shows [8c 8h] (a pair of Eights)
18nina18: shows [Js 9h] (high card Ace)
alanzao collected 2975 from pot
18nina18 finished the tournament
*** SUMMARY ***
Total pot 2975 | Rake 0 
Board [7c Ad 3h Ks 2s]
Seat 1: frost3ggg folded before Flop (didn't bet)
Seat 2: 18nina18 showed [Js 9h] and lost with high card Ace
Seat 3: Vlad0184 (button) folded before Flop (didn't bet)
Seat 4: comeecome88 (small blind) folded before Flop
Seat 5: alanzao (big blind) showed [8c 8h] and won (2975) with a pair of Eights
Seat 6: tuvshin777 folded before Flop (didn't bet)
Seat 7: pukola folded before Flop (didn't bet)
Seat 8: ollikahn23 folded before Flop (didn't bet)



PokerStars Hand #185453572505: Tournament #2282606587, $13.37+$1.63 USD Hold'em No Limit - Level IX (125/250) - 2018/04/20 9:38:13 ET
Table '2282606587 6' 9-max Seat #4 is the button
Seat 1: frost3ggg (12770 in chips) 
Seat 3: Vlad0184 (11528 in chips) 
Seat 4: comeecome88 (7874 in chips) 
Seat 5: alanzao (4490 in chips) 
Seat 6: tuvshin777 (2309 in chips) 
Seat 7: pukola (3065 in chips) 
Seat 8: ollikahn23 (10233 in chips) 
Seat 9: BuckFitchez (3000 in chips) 
frost3ggg: posts the ante 30
Vlad0184: posts the ante 30
comeecome88: posts the ante 30
alanzao: posts the ante 30
tuvshin777: posts the ante 30
pukola: posts the ante 30
ollikahn23: posts the ante 30
BuckFitchez: posts the ante 30
alanzao: posts small blind 125
tuvshin777: posts big blind 250
*** HOLE CARDS ***
Dealt to ollikahn23 [4h 6h]
pukola: folds 
ollikahn23: folds 
BuckFitchez: folds 
frost3ggg: folds 
Vlad0184: folds 
comeecome88: raises 250 to 500
alanzao: folds 
tuvshin777: folds 
Uncalled bet (250) returned to comeecome88
comeecome88 collected 865 from pot
*** SUMMARY ***
Total pot 865 | Rake 0 
Seat 1: frost3ggg folded before Flop (didn't bet)
Seat 3: Vlad0184 folded before Flop (didn't bet)
Seat 4: comeecome88 (button) collected (865)
Seat 5: alanzao (small blind) folded before Flop
Seat 6: tuvshin777 (big blind) folded before Flop
Seat 7: pukola folded before Flop (didn't bet)
Seat 8: ollikahn23 folded before Flop (didn't bet)
Seat 9: BuckFitchez folded before Flop (didn't bet)



PokerStars Hand #185453581706: Tournament #2282606587, $13.37+$1.63 USD Hold'em No Limit - Level IX (125/250) - 2018/04/20 9:38:32 ET
Table '2282606587 6' 9-max Seat #5 is the button
Seat 1: frost3ggg (12740 in chips) 
Seat 3: Vlad0184 (11498 in chips) 
Seat 4: comeecome88 (8459 in chips) 
Seat 5: alanzao (4335 in chips) 
Seat 6: tuvshin777 (2029 in chips) 
Seat 7: pukola (3035 in chips) 
Seat 8: ollikahn23 (10203 in chips) 
Seat 9: BuckFitchez (2970 in chips) 
frost3ggg: posts the ante 30
Vlad0184: posts the ante 30
comeecome88: posts the ante 30
alanzao: posts the ante 30
tuvshin777: posts the ante 30
pukola: posts the ante 30
ollikahn23: posts the ante 30
BuckFitchez: posts the ante 30
tuvshin777: posts small blind 125
pukola: posts big blind 250
*** HOLE CARDS ***
Dealt to ollikahn23 [4d 3h]
ollikahn23: folds 
BuckFitchez: folds 
frost3ggg: raises 375 to 625
Vlad0184: folds 
comeecome88: folds 
alanzao: folds 
tuvshin777: folds 
pukola: folds 
Uncalled bet (375) returned to frost3ggg
frost3ggg collected 865 from pot
*** SUMMARY ***
Total pot 865 | Rake 0 
Seat 1: frost3ggg collected (865)
Seat 3: Vlad0184 folded before Flop (didn't bet)
Seat 4: comeecome88 folded before Flop (didn't bet)
Seat 5: alanzao (button) folded before Flop (didn't bet)
Seat 6: tuvshin777 (small blind) folded before Flop
Seat 7: pukola (big blind) folded before Flop
Seat 8: ollikahn23 folded before Flop (didn't bet)
Seat 9: BuckFitchez folded before Flop (didn't bet)



PokerStars Hand #185453605938: Tournament #2282606587, $13.37+$1.63 USD Hold'em No Limit - Level X (150/300) - 2018/04/20 9:39:23 ET
Table '2282606587 6' 9-max Seat #6 is the button
Seat 1: frost3ggg (13325 in chips) 
Seat 2: w1n@w4r (14089 in chips) 
Seat 3: Vlad0184 (11468 in chips) 
Seat 4: comeecome88 (8429 in chips) 
Seat 5: alanzao (4305 in chips) 
Seat 6: tuvshin777 (1874 in chips) 
Seat 7: pukola (2755 in chips) 
Seat 8: ollikahn23 (10173 in chips) 
Seat 9: BuckFitchez (2940 in chips) 
frost3ggg: posts the ante 40
w1n@w4r: posts the ante 40
Vlad0184: posts the ante 40
comeecome88: posts the ante 40
alanzao: posts the ante 40
tuvshin777: posts the ante 40
pukola: posts the ante 40
ollikahn23: posts the ante 40
BuckFitchez: posts the ante 40
pukola: posts small blind 150
ollikahn23: posts big blind 300
*** HOLE CARDS ***
Dealt to ollikahn23 [3h 6h]
BuckFitchez: raises 2600 to 2900 and is all-in
frost3ggg: folds 
w1n@w4r: folds 
Vlad0184: folds 
comeecome88: folds 
alanzao: folds 
tuvshin777: folds 
pukola: folds 
ollikahn23: folds 
Uncalled bet (2600) returned to BuckFitchez
BuckFitchez collected 1110 from pot
*** SUMMARY ***
Total pot 1110 | Rake 0 
Seat 1: frost3ggg folded before Flop (didn't bet)
Seat 2: w1n@w4r folded before Flop (didn't bet)
Seat 3: Vlad0184 folded before Flop (didn't bet)
Seat 4: comeecome88 folded before Flop (didn't bet)
Seat 5: alanzao folded before Flop (didn't bet)
Seat 6: tuvshin777 (button) folded before Flop (didn't bet)
Seat 7: pukola (small blind) folded before Flop
Seat 8: ollikahn23 (big blind) folded before Flop
Seat 9: BuckFitchez collected (1110)



PokerStars Hand #185453621255: Tournament #2282606587, $13.37+$1.63 USD Hold'em No Limit - Level X (150/300) - 2018/04/20 9:39:55 ET
Table '2282606587 6' 9-max Seat #7 is the button
Seat 1: frost3ggg (13285 in chips) 
Seat 2: w1n@w4r (14049 in chips) 
Seat 3: Vlad0184 (11428 in chips) 
Seat 4: comeecome88 (8389 in chips) 
Seat 5: alanzao (4265 in chips) 
Seat 6: tuvshin777 (1834 in chips) 
Seat 7: pukola (2565 in chips) 
Seat 8: ollikahn23 (9833 in chips) 
Seat 9: BuckFitchez (3710 in chips) 
frost3ggg: posts the ante 40
w1n@w4r: posts the ante 40
Vlad0184: posts the ante 40
comeecome88: posts the ante 40
alanzao: posts the ante 40
tuvshin777: posts the ante 40
pukola: posts the ante 40
ollikahn23: posts the ante 40
BuckFitchez: posts the ante 40
ollikahn23: posts small blind 150
BuckFitchez: posts big blind 300
*** HOLE CARDS ***
Dealt to ollikahn23 [Qs Kd]
frost3ggg: folds 
w1n@w4r: raises 300 to 600
Vlad0184: calls 600
comeecome88: folds 
alanzao: folds 
tuvshin777: folds 
pukola: folds 
ollikahn23: folds 
BuckFitchez: folds 
*** FLOP *** [8c Ts 8d]
w1n@w4r: checks 
Vlad0184: checks 
*** TURN *** [8c Ts 8d] [2h]
w1n@w4r: checks 
Vlad0184: checks 
*** RIVER *** [8c Ts 8d 2h] [6d]
w1n@w4r: checks 
Vlad0184: checks 
*** SHOW DOWN ***
w1n@w4r: shows [Jh Ks] (a pair of Eights)
Vlad0184: shows [Js Ad] (a pair of Eights - Ace kicker)
Vlad0184 collected 2010 from pot
*** SUMMARY ***
Total pot 2010 | Rake 0 
Board [8c Ts 8d 2h 6d]
Seat 1: frost3ggg folded before Flop (didn't bet)
Seat 2: w1n@w4r showed [Jh Ks] and lost with a pair of Eights
Seat 3: Vlad0184 showed [Js Ad] and won (2010) with a pair of Eights
Seat 4: comeecome88 folded before Flop (didn't bet)
Seat 5: alanzao folded before Flop (didn't bet)
Seat 6: tuvshin777 folded before Flop (didn't bet)
Seat 7: pukola (button) folded before Flop (didn't bet)
Seat 8: ollikahn23 (small blind) folded before Flop
Seat 9: BuckFitchez (big blind) folded before Flop



PokerStars Hand #185453642250: Tournament #2282606587, $13.37+$1.63 USD Hold'em No Limit - Level X (150/300) - 2018/04/20 9:40:40 ET
Table '2282606587 6' 9-max Seat #8 is the button
Seat 1: frost3ggg (13245 in chips) 
Seat 2: w1n@w4r (13409 in chips) 
Seat 3: Vlad0184 (12798 in chips) 
Seat 4: comeecome88 (8349 in chips) 
Seat 5: alanzao (4225 in chips) 
Seat 6: tuvshin777 (1794 in chips) 
Seat 7: pukola (2525 in chips) 
Seat 8: ollikahn23 (9643 in chips) 
Seat 9: BuckFitchez (3370 in chips) 
frost3ggg: posts the ante 40
w1n@w4r: posts the ante 40
Vlad0184: posts the ante 40
comeecome88: posts the ante 40
alanzao: posts the ante 40
tuvshin777: posts the ante 40
pukola: posts the ante 40
ollikahn23: posts the ante 40
BuckFitchez: posts the ante 40
BuckFitchez: posts small blind 150
frost3ggg: posts big blind 300
*** HOLE CARDS ***
Dealt to ollikahn23 [6h 7h]
w1n@w4r: folds 
Vlad0184: folds 
comeecome88: folds 
alanzao: folds 
tuvshin777: folds 
pukola: folds 
ollikahn23: folds 
BuckFitchez: raises 3030 to 3330 and is all-in
frost3ggg: folds 
Uncalled bet (3030) returned to BuckFitchez
BuckFitchez collected 960 from pot
*** SUMMARY ***
Total pot 960 | Rake 0 
Seat 1: frost3ggg (big blind) folded before Flop
Seat 2: w1n@w4r folded before Flop (didn't bet)
Seat 3: Vlad0184 folded before Flop (didn't bet)
Seat 4: comeecome88 folded before Flop (didn't bet)
Seat 5: alanzao folded before Flop (didn't bet)
Seat 6: tuvshin777 folded before Flop (didn't bet)
Seat 7: pukola folded before Flop (didn't bet)
Seat 8: ollikahn23 (button) folded before Flop (didn't bet)
Seat 9: BuckFitchez (small blind) collected (960)



PokerStars Hand #185453652387: Tournament #2282606587, $13.37+$1.63 USD Hold'em No Limit - Level X (150/300) - 2018/04/20 9:41:01 ET
Table '2282606587 6' 9-max Seat #9 is the button
Seat 1: frost3ggg (12905 in chips) 
Seat 2: w1n@w4r (13369 in chips) 
Seat 3: Vlad0184 (12758 in chips) 
Seat 4: comeecome88 (8309 in chips) 
Seat 5: alanzao (4185 in chips) 
Seat 6: tuvshin777 (1754 in chips) 
Seat 7: pukola (2485 in chips) 
Seat 8: ollikahn23 (9603 in chips) 
Seat 9: BuckFitchez (3990 in chips) 
frost3ggg: posts the ante 40
w1n@w4r: posts the ante 40
Vlad0184: posts the ante 40
comeecome88: posts the ante 40
alanzao: posts the ante 40
tuvshin777: posts the ante 40
pukola: posts the ante 40
ollikahn23: posts the ante 40
BuckFitchez: posts the ante 40
frost3ggg: posts small blind 150
w1n@w4r: posts big blind 300
*** HOLE CARDS ***
Dealt to ollikahn23 [3h Qh]
Vlad0184: folds 
comeecome88: folds 
alanzao: folds 
tuvshin777: folds 
pukola: folds 
ollikahn23: folds 
BuckFitchez: folds 
frost3ggg: folds 
Uncalled bet (150) returned to w1n@w4r
w1n@w4r collected 660 from pot
w1n@w4r: doesn't show hand 
*** SUMMARY ***
Total pot 660 | Rake 0 
Seat 1: frost3ggg (small blind) folded before Flop
Seat 2: w1n@w4r (big blind) collected (660)
Seat 3: Vlad0184 folded before Flop (didn't bet)
Seat 4: comeecome88 folded before Flop (didn't bet)
Seat 5: alanzao folded before Flop (didn't bet)
Seat 6: tuvshin777 folded before Flop (didn't bet)
Seat 7: pukola folded before Flop (didn't bet)
Seat 8: ollikahn23 folded before Flop (didn't bet)
Seat 9: BuckFitchez (button) folded before Flop (didn't bet)



PokerStars Hand #185453663785: Tournament #2282606587, $13.37+$1.63 USD Hold'em No Limit - Level X (150/300) - 2018/04/20 9:41:25 ET
Table '2282606587 6' 9-max Seat #1 is the button
Seat 1: frost3ggg (12715 in chips) 
Seat 2: w1n@w4r (13839 in chips) 
Seat 3: Vlad0184 (12718 in chips) 
Seat 4: comeecome88 (8269 in chips) 
Seat 5: alanzao (4145 in chips) 
Seat 6: tuvshin777 (1714 in chips) 
Seat 7: pukola (2445 in chips) 
Seat 8: ollikahn23 (9563 in chips) 
Seat 9: BuckFitchez (3950 in chips) 
frost3ggg: posts the ante 40
w1n@w4r: posts the ante 40
Vlad0184: posts the ante 40
comeecome88: posts the ante 40
alanzao: posts the ante 40
tuvshin777: posts the ante 40
pukola: posts the ante 40
ollikahn23: posts the ante 40
BuckFitchez: posts the ante 40
w1n@w4r: posts small blind 150
Vlad0184: posts big blind 300
*** HOLE CARDS ***
Dealt to ollikahn23 [5d 7s]
comeecome88: folds 
alanzao: folds 
tuvshin777: raises 1374 to 1674 and is all-in
pukola: folds 
ollikahn23: folds 
BuckFitchez: folds 
frost3ggg: folds 
w1n@w4r: folds 
Vlad0184: folds 
Uncalled bet (1374) returned to tuvshin777
tuvshin777 collected 1110 from pot
tuvshin777: doesn't show hand 
*** SUMMARY ***
Total pot 1110 | Rake 0 
Seat 1: frost3ggg (button) folded before Flop (didn't bet)
Seat 2: w1n@w4r (small blind) folded before Flop
Seat 3: Vlad0184 (big blind) folded before Flop
Seat 4: comeecome88 folded before Flop (didn't bet)
Seat 5: alanzao folded before Flop (didn't bet)
Seat 6: tuvshin777 collected (1110)
Seat 7: pukola folded before Flop (didn't bet)
Seat 8: ollikahn23 folded before Flop (didn't bet)
Seat 9: BuckFitchez folded before Flop (didn't bet)



PokerStars Hand #185453672751: Tournament #2282606587, $13.37+$1.63 USD Hold'em No Limit - Level X (150/300) - 2018/04/20 9:41:44 ET
Table '2282606587 6' 9-max Seat #2 is the button
Seat 1: frost3ggg (12675 in chips) 
Seat 2: w1n@w4r (13649 in chips) 
Seat 3: Vlad0184 (12378 in chips) 
Seat 4: comeecome88 (8229 in chips) 
Seat 5: alanzao (4105 in chips) 
Seat 6: tuvshin777 (2484 in chips) 
Seat 7: pukola (2405 in chips) 
Seat 8: ollikahn23 (9523 in chips) 
Seat 9: BuckFitchez (3910 in chips) 
frost3ggg: posts the ante 40
w1n@w4r: posts the ante 40
Vlad0184: posts the ante 40
comeecome88: posts the ante 40
alanzao: posts the ante 40
tuvshin777: posts the ante 40
pukola: posts the ante 40
ollikahn23: posts the ante 40
BuckFitchez: posts the ante 40
Vlad0184: posts small blind 150
comeecome88: posts big blind 300
*** HOLE CARDS ***
Dealt to ollikahn23 [As 2h]
alanzao: folds 
tuvshin777: folds 
pukola: raises 2065 to 2365 and is all-in
ollikahn23: folds 
BuckFitchez: folds 
frost3ggg: calls 2365
w1n@w4r: folds 
Vlad0184: folds 
comeecome88: folds 
*** FLOP *** [4h 3c Ts]
*** TURN *** [4h 3c Ts] [Qc]
*** RIVER *** [4h 3c Ts Qc] [Ks]
*** SHOW DOWN ***
pukola: shows [Kh Qh] (two pair, Kings and Queens)
frost3ggg: shows [Ac Js] (a straight, Ten to Ace)
frost3ggg collected 5540 from pot
pukola finished the tournament
*** SUMMARY ***
Total pot 5540 | Rake 0 
Board [4h 3c Ts Qc Ks]
Seat 1: frost3ggg showed [Ac Js] and won (5540) with a straight, Ten to Ace
Seat 2: w1n@w4r (button) folded before Flop (didn't bet)
Seat 3: Vlad0184 (small blind) folded before Flop
Seat 4: comeecome88 (big blind) folded before Flop
Seat 5: alanzao folded before Flop (didn't bet)
Seat 6: tuvshin777 folded before Flop (didn't bet)
Seat 7: pukola showed [Kh Qh] and lost with two pair, Kings and Queens
Seat 8: ollikahn23 folded before Flop (didn't bet)
Seat 9: BuckFitchez folded before Flop (didn't bet)



PokerStars Hand #185453694674: Tournament #2282606587, $13.37+$1.63 USD Hold'em No Limit - Level X (150/300) - 2018/04/20 9:42:31 ET
Table '2282606587 6' 9-max Seat #3 is the button
Seat 1: frost3ggg (15810 in chips) 
Seat 2: w1n@w4r (13609 in chips) 
Seat 3: Vlad0184 (12188 in chips) 
Seat 4: comeecome88 (7889 in chips) 
Seat 5: alanzao (4065 in chips) 
Seat 6: tuvshin777 (2444 in chips) 
Seat 8: ollikahn23 (9483 in chips) 
Seat 9: BuckFitchez (3870 in chips) 
frost3ggg: posts the ante 40
w1n@w4r: posts the ante 40
Vlad0184: posts the ante 40
comeecome88: posts the ante 40
alanzao: posts the ante 40
tuvshin777: posts the ante 40
ollikahn23: posts the ante 40
BuckFitchez: posts the ante 40
comeecome88: posts small blind 150
alanzao: posts big blind 300
*** HOLE CARDS ***
Dealt to ollikahn23 [5d 8h]
tuvshin777: folds 
ollikahn23: folds 
BuckFitchez: folds 
frost3ggg: folds 
w1n@w4r: raises 300 to 600
Vlad0184: folds 
comeecome88: raises 7249 to 7849 and is all-in
alanzao: folds 
w1n@w4r: calls 7249
*** FLOP *** [Qd 4s 4d]
*** TURN *** [Qd 4s 4d] [5s]
*** RIVER *** [Qd 4s 4d 5s] [9d]
*** SHOW DOWN ***
comeecome88: shows [Ac Js] (a pair of Fours)
w1n@w4r: shows [Kh Kd] (two pair, Kings and Fours)
w1n@w4r collected 16318 from pot
comeecome88 finished the tournament
*** SUMMARY ***
Total pot 16318 | Rake 0 
Board [Qd 4s 4d 5s 9d]
Seat 1: frost3ggg folded before Flop (didn't bet)
Seat 2: w1n@w4r showed [Kh Kd] and won (16318) with two pair, Kings and Fours
Seat 3: Vlad0184 (button) folded before Flop (didn't bet)
Seat 4: comeecome88 (small blind) showed [Ac Js] and lost with a pair of Fours
Seat 5: alanzao (big blind) folded before Flop
Seat 6: tuvshin777 folded before Flop (didn't bet)
Seat 8: ollikahn23 folded before Flop (didn't bet)
Seat 9: BuckFitchez folded before Flop (didn't bet)



PokerStars Hand #185453708460: Tournament #2282606587, $13.37+$1.63 USD Hold'em No Limit - Level X (150/300) - 2018/04/20 9:43:01 ET
Table '2282606587 6' 9-max Seat #5 is the button
Seat 1: frost3ggg (15770 in chips) 
Seat 2: w1n@w4r (22038 in chips) 
Seat 3: Vlad0184 (12148 in chips) 
Seat 5: alanzao (3725 in chips) 
Seat 6: tuvshin777 (2404 in chips) 
Seat 8: ollikahn23 (9443 in chips) 
Seat 9: BuckFitchez (3830 in chips) 
frost3ggg: posts the ante 40
w1n@w4r: posts the ante 40
Vlad0184: posts the ante 40
alanzao: posts the ante 40
tuvshin777: posts the ante 40
ollikahn23: posts the ante 40
BuckFitchez: posts the ante 40
tuvshin777: posts small blind 150
ollikahn23: posts big blind 300
*** HOLE CARDS ***
Dealt to ollikahn23 [9d 9c]
BuckFitchez: folds 
frost3ggg: folds 
w1n@w4r: folds 
Vlad0184: folds 
alanzao: raises 3385 to 3685 and is all-in
tuvshin777: folds 
ollikahn23: calls 3385
*** FLOP *** [Tc 5c Ac]
*** TURN *** [Tc 5c Ac] [4c]
*** RIVER *** [Tc 5c Ac 4c] [9s]
*** SHOW DOWN ***
ollikahn23: shows [9d 9c] (a flush, Ace high)
alanzao: shows [Qh Jh] (high card Ace)
ollikahn23 collected 7800 from pot
alanzao finished the tournament
*** SUMMARY ***
Total pot 7800 | Rake 0 
Board [Tc 5c Ac 4c 9s]
Seat 1: frost3ggg folded before Flop (didn't bet)
Seat 2: w1n@w4r folded before Flop (didn't bet)
Seat 3: Vlad0184 folded before Flop (didn't bet)
Seat 5: alanzao (button) showed [Qh Jh] and lost with high card Ace
Seat 6: tuvshin777 (small blind) folded before Flop
Seat 8: ollikahn23 (big blind) showed [9d 9c] and won (7800) with a flush, Ace high
Seat 9: BuckFitchez folded before Flop (didn't bet)



PokerStars Hand #185453719579: Tournament #2282606587, $13.37+$1.63 USD Hold'em No Limit - Level X (150/300) - 2018/04/20 9:43:24 ET
Table '2282606587 6' 9-max Seat #6 is the button
Seat 1: frost3ggg (15730 in chips) 
Seat 2: w1n@w4r (21998 in chips) 
Seat 3: Vlad0184 (12108 in chips) 
Seat 4: KickAssPoker#1 (39399 in chips) 
Seat 6: tuvshin777 (2214 in chips) 
Seat 7: 1JORSON (3641 in chips) out of hand (moved from another table into small blind)
Seat 8: ollikahn23 (13518 in chips) 
Seat 9: BuckFitchez (3790 in chips) 
1JORSON will be allowed to play after the button
frost3ggg: posts the ante 40
w1n@w4r: posts the ante 40
Vlad0184: posts the ante 40
KickAssPoker#1: posts the ante 40
tuvshin777: posts the ante 40
ollikahn23: posts the ante 40
BuckFitchez: posts the ante 40
ollikahn23: posts small blind 150
BuckFitchez: posts big blind 300
*** HOLE CARDS ***
Dealt to ollikahn23 [6s 3h]
frost3ggg: folds 
w1n@w4r: raises 300 to 600
Vlad0184: folds 
KickAssPoker#1: raises 1600 to 2200
tuvshin777: folds 
ollikahn23: folds 
BuckFitchez: folds 
w1n@w4r: calls 1600
*** FLOP *** [Qc Jc Tc]
w1n@w4r: checks 
KickAssPoker#1: bets 2300
w1n@w4r: folds 
Uncalled bet (2300) returned to KickAssPoker#1
KickAssPoker#1 collected 5130 from pot
KickAssPoker#1: doesn't show hand 
*** SUMMARY ***
Total pot 5130 | Rake 0 
Board [Qc Jc Tc]
Seat 1: frost3ggg folded before Flop (didn't bet)
Seat 2: w1n@w4r folded on the Flop
Seat 3: Vlad0184 folded before Flop (didn't bet)
Seat 4: KickAssPoker#1 collected (5130)
Seat 6: tuvshin777 (button) folded before Flop (didn't bet)
Seat 8: ollikahn23 (small blind) folded before Flop
Seat 9: BuckFitchez (big blind) folded before Flop



PokerStars Hand #185453743964: Tournament #2282606587, $13.37+$1.63 USD Hold'em No Limit - Level X (150/300) - 2018/04/20 9:44:16 ET
Table '2282606587 6' 9-max Seat #8 is the button
Seat 1: frost3ggg (15690 in chips) 
Seat 2: w1n@w4r (19758 in chips) 
Seat 3: Vlad0184 (12068 in chips) 
Seat 4: KickAssPoker#1 (42289 in chips) 
Seat 6: tuvshin777 (2174 in chips) 
Seat 7: 1JORSON (3641 in chips) 
Seat 8: ollikahn23 (13328 in chips) 
Seat 9: BuckFitchez (3450 in chips) 
frost3ggg: posts the ante 40
w1n@w4r: posts the ante 40
Vlad0184: posts the ante 40
KickAssPoker#1: posts the ante 40
tuvshin777: posts the ante 40
1JORSON: posts the ante 40
ollikahn23: posts the ante 40
BuckFitchez: posts the ante 40
BuckFitchez: posts small blind 150
frost3ggg: posts big blind 300
*** HOLE CARDS ***
Dealt to ollikahn23 [Kd Th]
w1n@w4r: folds 
Vlad0184: folds 
KickAssPoker#1: raises 400 to 700
tuvshin777: folds 
1JORSON: raises 2901 to 3601 and is all-in
ollikahn23: folds 
BuckFitchez: folds 
frost3ggg: folds 
KickAssPoker#1: calls 2901
*** FLOP *** [As 8c Qh]
*** TURN *** [As 8c Qh] [7s]
*** RIVER *** [As 8c Qh 7s] [8s]
*** SHOW DOWN ***
KickAssPoker#1: shows [Ad 4d] (two pair, Aces and Eights)
1JORSON: shows [7d 7c] (a full house, Sevens full of Eights)
1JORSON collected 7972 from pot
*** SUMMARY ***
Total pot 7972 | Rake 0 
Board [As 8c Qh 7s 8s]
Seat 1: frost3ggg (big blind) folded before Flop
Seat 2: w1n@w4r folded before Flop (didn't bet)
Seat 3: Vlad0184 folded before Flop (didn't bet)
Seat 4: KickAssPoker#1 showed [Ad 4d] and lost with two pair, Aces and Eights
Seat 6: tuvshin777 folded before Flop (didn't bet)
Seat 7: 1JORSON showed [7d 7c] and won (7972) with a full house, Sevens full of Eights
Seat 8: ollikahn23 (button) folded before Flop (didn't bet)
Seat 9: BuckFitchez (small blind) folded before Flop



PokerStars Hand #185453768129: Tournament #2282606587, $13.37+$1.63 USD Hold'em No Limit - Level X (150/300) - 2018/04/20 9:45:08 ET
Table '2282606587 6' 9-max Seat #9 is the button
Seat 1: frost3ggg (15350 in chips) 
Seat 2: w1n@w4r (19718 in chips) 
Seat 3: Vlad0184 (12028 in chips) 
Seat 4: KickAssPoker#1 (38648 in chips) 
Seat 6: tuvshin777 (2134 in chips) 
Seat 7: 1JORSON (7972 in chips) 
Seat 8: ollikahn23 (13288 in chips) 
Seat 9: BuckFitchez (3260 in chips) 
frost3ggg: posts the ante 40
w1n@w4r: posts the ante 40
Vlad0184: posts the ante 40
KickAssPoker#1: posts the ante 40
tuvshin777: posts the ante 40
1JORSON: posts the ante 40
ollikahn23: posts the ante 40
BuckFitchez: posts the ante 40
frost3ggg: posts small blind 150
w1n@w4r: posts big blind 300
*** HOLE CARDS ***
Dealt to ollikahn23 [9s 3h]
Vlad0184: folds 
KickAssPoker#1: folds 
tuvshin777: folds 
1JORSON: folds 
ollikahn23: folds 
BuckFitchez: folds 
frost3ggg: calls 150
w1n@w4r: checks 
*** FLOP *** [Jc Tc 5s]
frost3ggg: bets 626
w1n@w4r: folds 
Uncalled bet (626) returned to frost3ggg
frost3ggg collected 920 from pot
*** SUMMARY ***
Total pot 920 | Rake 0 
Board [Jc Tc 5s]
Seat 1: frost3ggg (small blind) collected (920)
Seat 2: w1n@w4r (big blind) folded on the Flop
Seat 3: Vlad0184 folded before Flop (didn't bet)
Seat 4: KickAssPoker#1 folded before Flop (didn't bet)
Seat 6: tuvshin777 folded before Flop (didn't bet)
Seat 7: 1JORSON folded before Flop (didn't bet)
Seat 8: ollikahn23 folded before Flop (didn't bet)
Seat 9: BuckFitchez (button) folded before Flop (didn't bet)



PokerStars Hand #185453786204: Tournament #2282606587, $13.37+$1.63 USD Hold'em No Limit - Level X (150/300) - 2018/04/20 9:45:46 ET
Table '2282606587 6' 9-max Seat #1 is the button
Seat 1: frost3ggg (15930 in chips) 
Seat 2: w1n@w4r (19378 in chips) 
Seat 3: Vlad0184 (11988 in chips) 
Seat 4: KickAssPoker#1 (38608 in chips) 
Seat 6: tuvshin777 (2094 in chips) 
Seat 7: 1JORSON (7932 in chips) 
Seat 8: ollikahn23 (13248 in chips) 
Seat 9: BuckFitchez (3220 in chips) 
frost3ggg: posts the ante 40
w1n@w4r: posts the ante 40
Vlad0184: posts the ante 40
KickAssPoker#1: posts the ante 40
tuvshin777: posts the ante 40
1JORSON: posts the ante 40
ollikahn23: posts the ante 40
BuckFitchez: posts the ante 40
w1n@w4r: posts small blind 150
Vlad0184: posts big blind 300
*** HOLE CARDS ***
Dealt to ollikahn23 [Tc 9h]
KickAssPoker#1: folds 
tuvshin777: raises 1754 to 2054 and is all-in
1JORSON: folds 
ollikahn23: folds 
BuckFitchez: folds 
frost3ggg: folds 
w1n@w4r: folds 
Vlad0184: calls 1754
*** FLOP *** [Qd Qs 2c]
*** TURN *** [Qd Qs 2c] [8c]
*** RIVER *** [Qd Qs 2c 8c] [9s]
*** SHOW DOWN ***
Vlad0184: shows [Js Ac] (a pair of Queens)
tuvshin777: shows [8d 8h] (a full house, Eights full of Queens)
tuvshin777 collected 4578 from pot
*** SUMMARY ***
Total pot 4578 | Rake 0 
Board [Qd Qs 2c 8c 9s]
Seat 1: frost3ggg (button) folded before Flop (didn't bet)
Seat 2: w1n@w4r (small blind) folded before Flop
Seat 3: Vlad0184 (big blind) showed [Js Ac] and lost with a pair of Queens
Seat 4: KickAssPoker#1 folded before Flop (didn't bet)
Seat 6: tuvshin777 showed [8d 8h] and won (4578) with a full house, Eights full of Queens
Seat 7: 1JORSON folded before Flop (didn't bet)
Seat 8: ollikahn23 folded before Flop (didn't bet)
Seat 9: BuckFitchez folded before Flop (didn't bet)



PokerStars Hand #185453802311: Tournament #2282606587, $13.37+$1.63 USD Hold'em No Limit - Level X (150/300) - 2018/04/20 9:46:21 ET
Table '2282606587 6' 9-max Seat #3 is the button
Seat 1: frost3ggg (15890 in chips) 
Seat 3: Vlad0184 (9894 in chips) 
Seat 4: KickAssPoker#1 (38568 in chips) 
Seat 5: Ariguzblack (3000 in chips) 
Seat 6: tuvshin777 (4578 in chips) 
Seat 7: 1JORSON (7892 in chips) 
Seat 8: ollikahn23 (13208 in chips) 
Seat 9: BuckFitchez (3180 in chips) 
frost3ggg: posts the ante 40
Vlad0184: posts the ante 40
KickAssPoker#1: posts the ante 40
Ariguzblack: posts the ante 40
tuvshin777: posts the ante 40
1JORSON: posts the ante 40
ollikahn23: posts the ante 40
BuckFitchez: posts the ante 40
KickAssPoker#1: posts small blind 150
Ariguzblack: posts big blind 300
*** HOLE CARDS ***
Dealt to ollikahn23 [Jh Td]
tuvshin777: folds 
1JORSON: folds 
ollikahn23: folds 
BuckFitchez: folds 
frost3ggg: folds 
Vlad0184: folds 
KickAssPoker#1: raises 38228 to 38528 and is all-in
Ariguzblack: calls 2660 and is all-in
Uncalled bet (35568) returned to KickAssPoker#1
*** FLOP *** [5c Th 3h]
*** TURN *** [5c Th 3h] [7s]
*** RIVER *** [5c Th 3h 7s] [9h]
*** SHOW DOWN ***
KickAssPoker#1: shows [4d Kh] (high card King)
Ariguzblack: shows [Jd As] (high card Ace)
Ariguzblack collected 6240 from pot
*** SUMMARY ***
Total pot 6240 | Rake 0 
Board [5c Th 3h 7s 9h]
Seat 1: frost3ggg folded before Flop (didn't bet)
Seat 3: Vlad0184 (button) folded before Flop (didn't bet)
Seat 4: KickAssPoker#1 (small blind) showed [4d Kh] and lost with high card King
Seat 5: Ariguzblack (big blind) showed [Jd As] and won (6240) with high card Ace
Seat 6: tuvshin777 folded before Flop (didn't bet)
Seat 7: 1JORSON folded before Flop (didn't bet)
Seat 8: ollikahn23 folded before Flop (didn't bet)
Seat 9: BuckFitchez folded before Flop (didn't bet)



PokerStars Hand #185453814715: Tournament #2282606587, $13.37+$1.63 USD Hold'em No Limit - Level X (150/300) - 2018/04/20 9:46:47 ET
Table '2282606587 6' 9-max Seat #4 is the button
Seat 1: frost3ggg (15850 in chips) 
Seat 3: Vlad0184 (9854 in chips) 
Seat 4: KickAssPoker#1 (35568 in chips) 
Seat 5: Ariguzblack (6240 in chips) 
Seat 6: tuvshin777 (4538 in chips) 
Seat 7: 1JORSON (7852 in chips) 
Seat 8: ollikahn23 (13168 in chips) 
Seat 9: BuckFitchez (3140 in chips) 
frost3ggg: posts the ante 40
Vlad0184: posts the ante 40
KickAssPoker#1: posts the ante 40
Ariguzblack: posts the ante 40
tuvshin777: posts the ante 40
1JORSON: posts the ante 40
ollikahn23: posts the ante 40
BuckFitchez: posts the ante 40
Ariguzblack: posts small blind 150
tuvshin777: posts big blind 300
*** HOLE CARDS ***
Dealt to ollikahn23 [Td Ac]
1JORSON: folds 
ollikahn23: raises 306 to 606
BuckFitchez: folds 
frost3ggg: folds 
Vlad0184: folds 
KickAssPoker#1: folds 
Ariguzblack: folds 
tuvshin777: calls 306
*** FLOP *** [7s 4c Qh]
tuvshin777: checks 
ollikahn23: bets 707
tuvshin777: raises 707 to 1414
ollikahn23: raises 1886 to 3300
tuvshin777: raises 592 to 3892 and is all-in
ollikahn23: calls 592
*** TURN *** [7s 4c Qh] [Jd]
*** RIVER *** [7s 4c Qh Jd] [Js]
*** SHOW DOWN ***
tuvshin777: shows [Kc Qc] (two pair, Queens and Jacks)
ollikahn23: shows [Td Ac] (a pair of Jacks)
tuvshin777 collected 9466 from pot
*** SUMMARY ***
Total pot 9466 | Rake 0 
Board [7s 4c Qh Jd Js]
Seat 1: frost3ggg folded before Flop (didn't bet)
Seat 3: Vlad0184 folded before Flop (didn't bet)
Seat 4: KickAssPoker#1 (button) folded before Flop (didn't bet)
Seat 5: Ariguzblack (small blind) folded before Flop
Seat 6: tuvshin777 (big blind) showed [Kc Qc] and won (9466) with two pair, Queens and Jacks
Seat 7: 1JORSON folded before Flop (didn't bet)
Seat 8: ollikahn23 showed [Td Ac] and lost with a pair of Jacks
Seat 9: BuckFitchez folded before Flop (didn't bet)



PokerStars Hand #185453845418: Tournament #2282606587, $13.37+$1.63 USD Hold'em No Limit - Level X (150/300) - 2018/04/20 9:47:52 ET
Table '2282606587 6' 9-max Seat #5 is the button
Seat 1: frost3ggg (15810 in chips) 
Seat 2: Ineedyours (3000 in chips) 
Seat 3: Vlad0184 (9814 in chips) 
Seat 4: KickAssPoker#1 (35528 in chips) 
Seat 5: Ariguzblack (6050 in chips) 
Seat 6: tuvshin777 (9466 in chips) 
Seat 7: 1JORSON (7812 in chips) 
Seat 8: ollikahn23 (8630 in chips) 
Seat 9: BuckFitchez (3100 in chips) 
frost3ggg: posts the ante 40
Ineedyours: posts the ante 40
Vlad0184: posts the ante 40
KickAssPoker#1: posts the ante 40
Ariguzblack: posts the ante 40
tuvshin777: posts the ante 40
1JORSON: posts the ante 40
ollikahn23: posts the ante 40
BuckFitchez: posts the ante 40
tuvshin777: posts small blind 150
1JORSON: posts big blind 300
*** HOLE CARDS ***
Dealt to ollikahn23 [9d Ts]
ollikahn23: folds 
BuckFitchez: folds 
frost3ggg: folds 
Ineedyours: raises 300 to 600
Vlad0184: folds 
KickAssPoker#1: raises 2100 to 2700
Ariguzblack: folds 
tuvshin777: folds 
1JORSON is connected 
1JORSON: folds 
Ineedyours: calls 2100
*** FLOP *** [Kc Qd 7h]
Ineedyours: bets 260 and is all-in
KickAssPoker#1: calls 260
*** TURN *** [Kc Qd 7h] [Qh]
*** RIVER *** [Kc Qd 7h Qh] [8d]
*** SHOW DOWN ***
Ineedyours: shows [9c Kh] (two pair, Kings and Queens)
KickAssPoker#1: shows [8h As] (two pair, Queens and Eights)
Ineedyours collected 6730 from pot
*** SUMMARY ***
Total pot 6730 | Rake 0 
Board [Kc Qd 7h Qh 8d]
Seat 1: frost3ggg folded before Flop (didn't bet)
Seat 2: Ineedyours showed [9c Kh] and won (6730) with two pair, Kings and Queens
Seat 3: Vlad0184 folded before Flop (didn't bet)
Seat 4: KickAssPoker#1 showed [8h As] and lost with two pair, Queens and Eights
Seat 5: Ariguzblack (button) folded before Flop (didn't bet)
Seat 6: tuvshin777 (small blind) folded before Flop
Seat 7: 1JORSON (big blind) folded before Flop
Seat 8: ollikahn23 folded before Flop (didn't bet)
Seat 9: BuckFitchez folded before Flop (didn't bet)



PokerStars Hand #185453883316: Tournament #2282606587, $13.37+$1.63 USD Hold'em No Limit - Level XI (200/400) - 2018/04/20 9:49:12 ET
Table '2282606587 6' 9-max Seat #6 is the button
Seat 1: frost3ggg (15770 in chips) 
Seat 2: Ineedyours (6730 in chips) 
Seat 3: Vlad0184 (9774 in chips) 
Seat 4: KickAssPoker#1 (32528 in chips) 
Seat 5: Ariguzblack (6010 in chips) 
Seat 6: tuvshin777 (9276 in chips) 
Seat 7: 1JORSON (7472 in chips) 
Seat 8: ollikahn23 (8590 in chips) 
Seat 9: BuckFitchez (3060 in chips) 
frost3ggg: posts the ante 50
Ineedyours: posts the ante 50
Vlad0184: posts the ante 50
KickAssPoker#1: posts the ante 50
Ariguzblack: posts the ante 50
tuvshin777: posts the ante 50
1JORSON: posts the ante 50
ollikahn23: posts the ante 50
BuckFitchez: posts the ante 50
1JORSON: posts small blind 200
ollikahn23: posts big blind 400
*** HOLE CARDS ***
Dealt to ollikahn23 [Jh 7c]
BuckFitchez: raises 2610 to 3010 and is all-in
frost3ggg: calls 3010
Ineedyours: folds 
Vlad0184: folds 
KickAssPoker#1: folds 
Ariguzblack: folds 
tuvshin777: folds 
1JORSON: folds 
ollikahn23: folds 
*** FLOP *** [9h Ks 2h]
*** TURN *** [9h Ks 2h] [9s]
*** RIVER *** [9h Ks 2h 9s] [Qh]
*** SHOW DOWN ***
BuckFitchez: shows [8s 8d] (two pair, Nines and Eights)
frost3ggg: shows [Ad Ah] (two pair, Aces and Nines)
frost3ggg collected 7070 from pot
BuckFitchez finished the tournament in 94th place
*** SUMMARY ***
Total pot 7070 | Rake 0 
Board [9h Ks 2h 9s Qh]
Seat 1: frost3ggg showed [Ad Ah] and won (7070) with two pair, Aces and Nines
Seat 2: Ineedyours folded before Flop (didn't bet)
Seat 3: Vlad0184 folded before Flop (didn't bet)
Seat 4: KickAssPoker#1 folded before Flop (didn't bet)
Seat 5: Ariguzblack folded before Flop (didn't bet)
Seat 6: tuvshin777 (button) folded before Flop (didn't bet)
Seat 7: 1JORSON (small blind) folded before Flop
Seat 8: ollikahn23 (big blind) folded before Flop
Seat 9: BuckFitchez showed [8s 8d] and lost with two pair, Nines and Eights



PokerStars Hand #185453896663: Tournament #2282606587, $13.37+$1.63 USD Hold'em No Limit - Level XI (200/400) - 2018/04/20 9:49:41 ET
Table '2282606587 6' 9-max Seat #7 is the button
Seat 1: frost3ggg (19780 in chips) 
Seat 2: Ineedyours (6680 in chips) 
Seat 3: Vlad0184 (9724 in chips) 
Seat 4: KickAssPoker#1 (32478 in chips) 
Seat 5: Ariguzblack (5960 in chips) 
Seat 6: tuvshin777 (9226 in chips) 
Seat 7: 1JORSON (7222 in chips) 
Seat 8: ollikahn23 (8140 in chips) 
frost3ggg: posts the ante 50
Ineedyours: posts the ante 50
Vlad0184: posts the ante 50
KickAssPoker#1: posts the ante 50
Ariguzblack: posts the ante 50
tuvshin777: posts the ante 50
1JORSON: posts the ante 50
ollikahn23: posts the ante 50
ollikahn23: posts small blind 200
frost3ggg: posts big blind 400
*** HOLE CARDS ***
Dealt to ollikahn23 [3d 4h]
Ineedyours: calls 400
Vlad0184: folds 
KickAssPoker#1: raises 2400 to 2800
Ariguzblack: folds 
tuvshin777: folds 
1JORSON: folds 
ollikahn23: folds 
frost3ggg: folds 
Ineedyours: calls 2400
*** FLOP *** [Qs 3h 4s]
Ineedyours: bets 1200
KickAssPoker#1: raises 1500 to 2700
Ineedyours: calls 1500
*** TURN *** [Qs 3h 4s] [As]
Ineedyours: bets 1130 and is all-in
KickAssPoker#1: calls 1130
*** RIVER *** [Qs 3h 4s As] [3s]
*** SHOW DOWN ***
Ineedyours: shows [Ts Ac] (a flush, Ace high)
KickAssPoker#1: shows [Js Ks] (a flush, Ace high - King higher)
KickAssPoker#1 collected 14260 from pot
Ineedyours finished the tournament in 90th place
*** SUMMARY ***
Total pot 14260 | Rake 0 
Board [Qs 3h 4s As 3s]
Seat 1: frost3ggg (big blind) folded before Flop
Seat 2: Ineedyours showed [Ts Ac] and lost with a flush, Ace high
Seat 3: Vlad0184 folded before Flop (didn't bet)
Seat 4: KickAssPoker#1 showed [Js Ks] and won (14260) with a flush, Ace high
Seat 5: Ariguzblack folded before Flop (didn't bet)
Seat 6: tuvshin777 folded before Flop (didn't bet)
Seat 7: 1JORSON (button) folded before Flop (didn't bet)
Seat 8: ollikahn23 (small blind) folded before Flop



PokerStars Hand #185453950395: Tournament #2282606587, $13.37+$1.63 USD Hold'em No Limit - Level XI (200/400) - 2018/04/20 9:51:36 ET
Table '2282606587 6' 9-max Seat #8 is the button
Seat 1: frost3ggg (19330 in chips) 
Seat 3: Vlad0184 (9674 in chips) 
Seat 4: KickAssPoker#1 (40058 in chips) 
Seat 5: Ariguzblack (5910 in chips) 
Seat 6: tuvshin777 (9176 in chips) 
Seat 7: 1JORSON (7172 in chips) 
Seat 8: ollikahn23 (7890 in chips) 
Seat 9: pokermanga (26615 in chips) out of hand (moved from another table into small blind)
pokermanga will be allowed to play after the button
frost3ggg: posts the ante 50
Vlad0184: posts the ante 50
KickAssPoker#1: posts the ante 50
Ariguzblack: posts the ante 50
tuvshin777: posts the ante 50
1JORSON: posts the ante 50
ollikahn23: posts the ante 50
frost3ggg: posts small blind 200
Vlad0184: posts big blind 400
*** HOLE CARDS ***
Dealt to ollikahn23 [Tc Qh]
KickAssPoker#1: raises 400 to 800
Ariguzblack: folds 
tuvshin777: folds 
1JORSON: calls 800
ollikahn23: calls 800
frost3ggg: folds 
Vlad0184: folds 
*** FLOP *** [2c 8h 3h]
KickAssPoker#1: bets 1675
1JORSON: raises 4647 to 6322 and is all-in
ollikahn23: folds 
KickAssPoker#1: folds 
Uncalled bet (4647) returned to 1JORSON
1JORSON collected 6700 from pot
*** SUMMARY ***
Total pot 6700 | Rake 0 
Board [2c 8h 3h]
Seat 1: frost3ggg (small blind) folded before Flop
Seat 3: Vlad0184 (big blind) folded before Flop
Seat 4: KickAssPoker#1 folded on the Flop
Seat 5: Ariguzblack folded before Flop (didn't bet)
Seat 6: tuvshin777 folded before Flop (didn't bet)
Seat 7: 1JORSON collected (6700)
Seat 8: ollikahn23 (button) folded on the Flop



PokerStars Hand #185453965742: Tournament #2282606587, $13.37+$1.63 USD Hold'em No Limit - Level XI (200/400) - 2018/04/20 9:52:08 ET
Table '2282606587 6' 9-max Seat #1 is the button
Seat 1: frost3ggg (19080 in chips) 
Seat 3: Vlad0184 (9224 in chips) 
Seat 4: KickAssPoker#1 (37533 in chips) 
Seat 5: Ariguzblack (5860 in chips) 
Seat 6: tuvshin777 (9126 in chips) 
Seat 7: 1JORSON (11347 in chips) 
Seat 8: ollikahn23 (7040 in chips) 
Seat 9: pokermanga (26615 in chips) 
frost3ggg: posts the ante 50
Vlad0184: posts the ante 50
KickAssPoker#1: posts the ante 50
Ariguzblack: posts the ante 50
tuvshin777: posts the ante 50
1JORSON: posts the ante 50
ollikahn23: posts the ante 50
pokermanga: posts the ante 50
Vlad0184: posts small blind 200
KickAssPoker#1: posts big blind 400
*** HOLE CARDS ***
Dealt to ollikahn23 [8c 8d]
Ariguzblack: folds 
tuvshin777: folds 
1JORSON: folds 
ollikahn23: raises 6590 to 6990 and is all-in
pokermanga: folds 
frost3ggg: folds 
Vlad0184: folds 
KickAssPoker#1: folds 
Uncalled bet (6590) returned to ollikahn23
ollikahn23 collected 1400 from pot
ollikahn23: doesn't show hand 
*** SUMMARY ***
Total pot 1400 | Rake 0 
Seat 1: frost3ggg (button) folded before Flop (didn't bet)
Seat 3: Vlad0184 (small blind) folded before Flop
Seat 4: KickAssPoker#1 (big blind) folded before Flop
Seat 5: Ariguzblack folded before Flop (didn't bet)
Seat 6: tuvshin777 folded before Flop (didn't bet)
Seat 7: 1JORSON folded before Flop (didn't bet)
Seat 8: ollikahn23 collected (1400)
Seat 9: pokermanga folded before Flop (didn't bet)



PokerStars Hand #185453973642: Tournament #2282606587, $13.37+$1.63 USD Hold'em No Limit - Level XI (200/400) - 2018/04/20 9:52:25 ET
Table '2282606587 6' 9-max Seat #3 is the button
Seat 1: frost3ggg (19030 in chips) 
Seat 3: Vlad0184 (8974 in chips) 
Seat 4: KickAssPoker#1 (37083 in chips) 
Seat 5: Ariguzblack (5810 in chips) 
Seat 6: tuvshin777 (9076 in chips) 
Seat 7: 1JORSON (11297 in chips) 
Seat 8: ollikahn23 (7990 in chips) 
Seat 9: pokermanga (26565 in chips) 
frost3ggg: posts the ante 50
Vlad0184: posts the ante 50
KickAssPoker#1: posts the ante 50
Ariguzblack: posts the ante 50
tuvshin777: posts the ante 50
1JORSON: posts the ante 50
ollikahn23: posts the ante 50
pokermanga: posts the ante 50
KickAssPoker#1: posts small blind 200
Ariguzblack: posts big blind 400
*** HOLE CARDS ***
Dealt to ollikahn23 [Kh 4h]
tuvshin777: folds 
1JORSON: folds 
ollikahn23: folds 
pokermanga: folds 
frost3ggg: folds 
Vlad0184: folds 
KickAssPoker#1: calls 200
Ariguzblack: checks 
*** FLOP *** [Qc Ts 3s]
KickAssPoker#1: bets 400
Ariguzblack: calls 400
*** TURN *** [Qc Ts 3s] [2h]
KickAssPoker#1: checks 
Ariguzblack: checks 
*** RIVER *** [Qc Ts 3s 2h] [8c]
KickAssPoker#1: bets 2000
Ariguzblack: calls 2000
*** SHOW DOWN ***
KickAssPoker#1: shows [Qd 6s] (a pair of Queens)
Ariguzblack: mucks hand 
KickAssPoker#1 collected 6000 from pot
*** SUMMARY ***
Total pot 6000 | Rake 0 
Board [Qc Ts 3s 2h 8c]
Seat 1: frost3ggg folded before Flop (didn't bet)
Seat 3: Vlad0184 (button) folded before Flop (didn't bet)
Seat 4: KickAssPoker#1 (small blind) showed [Qd 6s] and won (6000) with a pair of Queens
Seat 5: Ariguzblack (big blind) mucked [Th 5s]
Seat 6: tuvshin777 folded before Flop (didn't bet)
Seat 7: 1JORSON folded before Flop (didn't bet)
Seat 8: ollikahn23 folded before Flop (didn't bet)
Seat 9: pokermanga folded before Flop (didn't bet)



PokerStars Hand #185453998317: Tournament #2282606587, $13.37+$1.63 USD Hold'em No Limit - Level XI (200/400) - 2018/04/20 9:53:17 ET
Table '2282606587 6' 9-max Seat #4 is the button
Seat 1: frost3ggg (18980 in chips) 
Seat 3: Vlad0184 (8924 in chips) 
Seat 4: KickAssPoker#1 (40233 in chips) 
Seat 5: Ariguzblack (2960 in chips) 
Seat 6: tuvshin777 (9026 in chips) 
Seat 7: 1JORSON (11247 in chips) 
Seat 8: ollikahn23 (7940 in chips) 
Seat 9: pokermanga (26515 in chips) 
frost3ggg: posts the ante 50
Vlad0184: posts the ante 50
KickAssPoker#1: posts the ante 50
Ariguzblack: posts the ante 50
tuvshin777: posts the ante 50
1JORSON: posts the ante 50
ollikahn23: posts the ante 50
pokermanga: posts the ante 50
Ariguzblack: posts small blind 200
tuvshin777: posts big blind 400
*** HOLE CARDS ***
Dealt to ollikahn23 [9c As]
1JORSON: folds 
ollikahn23: raises 408 to 808
pokermanga: folds 
frost3ggg: calls 808
Vlad0184: folds 
KickAssPoker#1: raises 39375 to 40183 and is all-in
Ariguzblack: folds 
tuvshin777: folds 
ollikahn23: folds 
frost3ggg: calls 18122 and is all-in
Uncalled bet (21253) returned to KickAssPoker#1
*** FLOP *** [Kd 8d Jh]
*** TURN *** [Kd 8d Jh] [5d]
*** RIVER *** [Kd 8d Jh 5d] [6d]
*** SHOW DOWN ***
frost3ggg: shows [Js Jc] (three of a kind, Jacks)
KickAssPoker#1: shows [4d 4c] (a flush, King high)
KickAssPoker#1 collected 39668 from pot
frost3ggg finished the tournament in 80th place
*** SUMMARY ***
Total pot 39668 | Rake 0 
Board [Kd 8d Jh 5d 6d]
Seat 1: frost3ggg showed [Js Jc] and lost with three of a kind, Jacks
Seat 3: Vlad0184 folded before Flop (didn't bet)
Seat 4: KickAssPoker#1 (button) showed [4d 4c] and won (39668) with a flush, King high
Seat 5: Ariguzblack (small blind) folded before Flop
Seat 6: tuvshin777 (big blind) folded before Flop
Seat 7: 1JORSON folded before Flop (didn't bet)
Seat 8: ollikahn23 folded before Flop
Seat 9: pokermanga folded before Flop (didn't bet)



PokerStars Hand #185454024767: Tournament #2282606587, $13.37+$1.63 USD Hold'em No Limit - Level XI (200/400) - 2018/04/20 9:54:13 ET
Table '2282606587 6' 9-max Seat #5 is the button
Seat 2: Advenator (17923 in chips) 
Seat 3: Vlad0184 (8874 in chips) 
Seat 4: KickAssPoker#1 (60921 in chips) 
Seat 5: Ariguzblack (2710 in chips) 
Seat 6: tuvshin777 (8576 in chips) 
Seat 7: 1JORSON (11197 in chips) 
Seat 8: ollikahn23 (7082 in chips) 
Seat 9: pokermanga (26465 in chips) 
Advenator: posts the ante 50
Vlad0184: posts the ante 50
KickAssPoker#1: posts the ante 50
Ariguzblack: posts the ante 50
tuvshin777: posts the ante 50
1JORSON: posts the ante 50
ollikahn23: posts the ante 50
pokermanga: posts the ante 50
tuvshin777: posts small blind 200
1JORSON: posts big blind 400
*** HOLE CARDS ***
Dealt to ollikahn23 [8s 7c]
ollikahn23: folds 
ollikahn23 said, "sick.."
pokermanga: folds 
Advenator: raises 440 to 840
pokermanga said, "lol"
Vlad0184: folds 
KickAssPoker#1: raises 2680 to 3520
Ariguzblack: folds 
tuvshin777: folds 
1JORSON: folds 
Advenator: folds 
Uncalled bet (2680) returned to KickAssPoker#1
KickAssPoker#1 collected 2680 from pot
KickAssPoker#1: doesn't show hand 
*** SUMMARY ***
Total pot 2680 | Rake 0 
Seat 2: Advenator folded before Flop
Seat 3: Vlad0184 folded before Flop (didn't bet)
Seat 4: KickAssPoker#1 collected (2680)
Seat 5: Ariguzblack (button) folded before Flop (didn't bet)
Seat 6: tuvshin777 (small blind) folded before Flop
Seat 7: 1JORSON (big blind) folded before Flop
Seat 8: ollikahn23 folded before Flop (didn't bet)
Seat 9: pokermanga folded before Flop (didn't bet)



PokerStars Hand #185454046370: Tournament #2282606587, $13.37+$1.63 USD Hold'em No Limit - Level XI (200/400) - 2018/04/20 9:54:58 ET
Table '2282606587 6' 9-max Seat #6 is the button
Seat 2: Advenator (17033 in chips) 
Seat 3: Vlad0184 (8824 in chips) 
Seat 4: KickAssPoker#1 (62711 in chips) 
Seat 5: Ariguzblack (2660 in chips) 
Seat 6: tuvshin777 (8326 in chips) 
Seat 7: 1JORSON (10747 in chips) 
Seat 8: ollikahn23 (7032 in chips) 
Seat 9: pokermanga (26415 in chips) 
Advenator: posts the ante 50
Vlad0184: posts the ante 50
KickAssPoker#1: posts the ante 50
Ariguzblack: posts the ante 50
tuvshin777: posts the ante 50
1JORSON: posts the ante 50
ollikahn23: posts the ante 50
pokermanga: posts the ante 50
1JORSON: posts small blind 200
ollikahn23: posts big blind 400
*** HOLE CARDS ***
Dealt to ollikahn23 [As 5h]
pokermanga: folds 
Advenator: calls 400
Vlad0184: folds 
KickAssPoker#1: folds 
Ariguzblack: folds 
tuvshin777: folds 
1JORSON: folds 
ollikahn23: raises 6582 to 6982 and is all-in
Advenator: folds 
Uncalled bet (6582) returned to ollikahn23
ollikahn23 collected 1400 from pot
ollikahn23: doesn't show hand 
*** SUMMARY ***
Total pot 1400 | Rake 0 
Seat 2: Advenator folded before Flop
Seat 3: Vlad0184 folded before Flop (didn't bet)
Seat 4: KickAssPoker#1 folded before Flop (didn't bet)
Seat 5: Ariguzblack folded before Flop (didn't bet)
Seat 6: tuvshin777 (button) folded before Flop (didn't bet)
Seat 7: 1JORSON (small blind) folded before Flop
Seat 8: ollikahn23 (big blind) collected (1400)
Seat 9: pokermanga folded before Flop (didn't bet)



PokerStars Hand #185454189859: Tournament #2282606587, $13.37+$1.63 USD Hold'em No Limit - Level XI (200/400) - 2018/04/20 10:00:43 ET
Table '2282606587 6' 9-max Seat #7 is the button
Seat 2: Advenator (16583 in chips) 
Seat 3: Vlad0184 (8774 in chips) 
Seat 4: KickAssPoker#1 (62661 in chips) 
Seat 5: Ariguzblack (2610 in chips) 
Seat 6: tuvshin777 (8276 in chips) 
Seat 7: 1JORSON (10497 in chips) 
Seat 8: ollikahn23 (7982 in chips) 
Seat 9: pokermanga (26365 in chips) 
Advenator: posts the ante 50
Vlad0184: posts the ante 50
KickAssPoker#1: posts the ante 50
Ariguzblack: posts the ante 50
tuvshin777: posts the ante 50
1JORSON: posts the ante 50
ollikahn23: posts the ante 50
pokermanga: posts the ante 50
ollikahn23: posts small blind 200
pokermanga: posts big blind 400
*** HOLE CARDS ***
Dealt to ollikahn23 [Ad 9h]
Advenator: folds 
Vlad0184: folds 
KickAssPoker#1: raises 400 to 800
Ariguzblack: folds 
tuvshin777: raises 1200 to 2000
1JORSON: folds 
ollikahn23: folds 
pokermanga: folds 
KickAssPoker#1: calls 1200
*** FLOP *** [7c 6s 5c]
KickAssPoker#1: bets 60611 and is all-in
tuvshin777: calls 6226 and is all-in
Uncalled bet (54385) returned to KickAssPoker#1
*** TURN *** [7c 6s 5c] [7d]
*** RIVER *** [7c 6s 5c 7d] [4d]
*** SHOW DOWN ***
KickAssPoker#1: shows [Kc Jh] (a pair of Sevens)
tuvshin777: shows [Ac Ah] (two pair, Aces and Sevens)
tuvshin777 collected 17452 from pot
*** SUMMARY ***
Total pot 17452 | Rake 0 
Board [7c 6s 5c 7d 4d]
Seat 2: Advenator folded before Flop (didn't bet)
Seat 3: Vlad0184 folded before Flop (didn't bet)
Seat 4: KickAssPoker#1 showed [Kc Jh] and lost with a pair of Sevens
Seat 5: Ariguzblack folded before Flop (didn't bet)
Seat 6: tuvshin777 showed [Ac Ah] and won (17452) with two pair, Aces and Sevens
Seat 7: 1JORSON (button) folded before Flop (didn't bet)
Seat 8: ollikahn23 (small blind) folded before Flop
Seat 9: pokermanga (big blind) folded before Flop



PokerStars Hand #185454225175: Tournament #2282606587, $13.37+$1.63 USD Hold'em No Limit - Level XI (200/400) - 2018/04/20 10:02:02 ET
Table '2282606587 6' 9-max Seat #8 is the button
Seat 1: Danillo.G007 (18800 in chips) 
Seat 2: Advenator (16533 in chips) 
Seat 3: Vlad0184 (8724 in chips) 
Seat 4: KickAssPoker#1 (54385 in chips) 
Seat 5: Ariguzblack (2560 in chips) 
Seat 6: tuvshin777 (17452 in chips) 
Seat 7: 1JORSON (10447 in chips) 
Seat 8: ollikahn23 (7732 in chips) 
Seat 9: pokermanga (25915 in chips) 
Danillo.G007: posts the ante 50
Advenator: posts the ante 50
Vlad0184: posts the ante 50
KickAssPoker#1: posts the ante 50
Ariguzblack: posts the ante 50
tuvshin777: posts the ante 50
1JORSON: posts the ante 50
ollikahn23: posts the ante 50
pokermanga: posts the ante 50
pokermanga: posts small blind 200
Danillo.G007: posts big blind 400
*** HOLE CARDS ***
Dealt to ollikahn23 [2s 6c]
Advenator: folds 
Vlad0184: folds 
KickAssPoker#1: raises 400 to 800
Ariguzblack: folds 
tuvshin777: folds 
1JORSON: calls 800
ollikahn23: folds 
pokermanga: folds 
Danillo.G007: calls 400
*** FLOP *** [Td 8c 4c]
Danillo.G007: checks 
KickAssPoker#1: bets 1525
1JORSON: folds 
Danillo.G007: calls 1525
*** TURN *** [Td 8c 4c] [3s]
Danillo.G007: checks 
KickAssPoker#1: bets 52010 and is all-in
Danillo.G007: folds 
Uncalled bet (52010) returned to KickAssPoker#1
KickAssPoker#1 collected 6100 from pot
KickAssPoker#1: doesn't show hand 
*** SUMMARY ***
Total pot 6100 | Rake 0 
Board [Td 8c 4c 3s]
Seat 1: Danillo.G007 (big blind) folded on the Turn
Seat 2: Advenator folded before Flop (didn't bet)
Seat 3: Vlad0184 folded before Flop (didn't bet)
Seat 4: KickAssPoker#1 collected (6100)
Seat 5: Ariguzblack folded before Flop (didn't bet)
Seat 6: tuvshin777 folded before Flop (didn't bet)
Seat 7: 1JORSON folded on the Flop
Seat 8: ollikahn23 (button) folded before Flop (didn't bet)
Seat 9: pokermanga (small blind) folded before Flop



PokerStars Hand #185454252622: Tournament #2282606587, $13.37+$1.63 USD Hold'em No Limit - Level XI (200/400) - 2018/04/20 10:02:59 ET
Table '2282606587 6' 9-max Seat #9 is the button
Seat 1: Danillo.G007 (16425 in chips) 
Seat 2: Advenator (16483 in chips) 
Seat 3: Vlad0184 (8674 in chips) 
Seat 4: KickAssPoker#1 (58110 in chips) 
Seat 5: Ariguzblack (2510 in chips) 
Seat 6: tuvshin777 (17402 in chips) 
Seat 7: 1JORSON (9597 in chips) 
Seat 8: ollikahn23 (7682 in chips) 
Seat 9: pokermanga (25665 in chips) 
Danillo.G007: posts the ante 50
Advenator: posts the ante 50
Vlad0184: posts the ante 50
KickAssPoker#1: posts the ante 50
Ariguzblack: posts the ante 50
tuvshin777: posts the ante 50
1JORSON: posts the ante 50
ollikahn23: posts the ante 50
pokermanga: posts the ante 50
Danillo.G007: posts small blind 200
Advenator: posts big blind 400
*** HOLE CARDS ***
Dealt to ollikahn23 [3s Kh]
Vlad0184: folds 
KickAssPoker#1: folds 
Ariguzblack: folds 
tuvshin777: folds 
1JORSON: folds 
ollikahn23: raises 7232 to 7632 and is all-in
pokermanga: folds 
Danillo.G007: folds 
Advenator: folds 
Uncalled bet (7232) returned to ollikahn23
ollikahn23 collected 1450 from pot
ollikahn23: doesn't show hand 
*** SUMMARY ***
Total pot 1450 | Rake 0 
Seat 1: Danillo.G007 (small blind) folded before Flop
Seat 2: Advenator (big blind) folded before Flop
Seat 3: Vlad0184 folded before Flop (didn't bet)
Seat 4: KickAssPoker#1 folded before Flop (didn't bet)
Seat 5: Ariguzblack folded before Flop (didn't bet)
Seat 6: tuvshin777 folded before Flop (didn't bet)
Seat 7: 1JORSON folded before Flop (didn't bet)
Seat 8: ollikahn23 collected (1450)
Seat 9: pokermanga (button) folded before Flop (didn't bet)



PokerStars Hand #185454274586: Tournament #2282606587, $13.37+$1.63 USD Hold'em No Limit - Level XI (200/400) - 2018/04/20 10:03:45 ET
Table '2282606587 6' 9-max Seat #1 is the button
Seat 1: Danillo.G007 (16175 in chips) 
Seat 2: Advenator (16033 in chips) 
Seat 3: Vlad0184 (8624 in chips) 
Seat 4: KickAssPoker#1 (58060 in chips) 
Seat 5: Ariguzblack (2460 in chips) 
Seat 6: tuvshin777 (17352 in chips) 
Seat 7: 1JORSON (9547 in chips) 
Seat 8: ollikahn23 (8682 in chips) 
Seat 9: pokermanga (25615 in chips) 
Danillo.G007: posts the ante 50
Advenator: posts the ante 50
Vlad0184: posts the ante 50
KickAssPoker#1: posts the ante 50
Ariguzblack: posts the ante 50
tuvshin777: posts the ante 50
1JORSON: posts the ante 50
ollikahn23: posts the ante 50
pokermanga: posts the ante 50
Advenator: posts small blind 200
Vlad0184: posts big blind 400
*** HOLE CARDS ***
Dealt to ollikahn23 [9c 3c]
KickAssPoker#1: folds 
Ariguzblack: raises 2010 to 2410 and is all-in
tuvshin777: folds 
1JORSON: folds 
ollikahn23: folds 
pokermanga: folds 
Danillo.G007: folds 
Advenator: folds 
Vlad0184: folds 
Uncalled bet (2010) returned to Ariguzblack
Ariguzblack collected 1450 from pot
*** SUMMARY ***
Total pot 1450 | Rake 0 
Seat 1: Danillo.G007 (button) folded before Flop (didn't bet)
Seat 2: Advenator (small blind) folded before Flop
Seat 3: Vlad0184 (big blind) folded before Flop
Seat 4: KickAssPoker#1 folded before Flop (didn't bet)
Seat 5: Ariguzblack collected (1450)
Seat 6: tuvshin777 folded before Flop (didn't bet)
Seat 7: 1JORSON folded before Flop (didn't bet)
Seat 8: ollikahn23 folded before Flop (didn't bet)
Seat 9: pokermanga folded before Flop (didn't bet)



PokerStars Hand #185454287952: Tournament #2282606587, $13.37+$1.63 USD Hold'em No Limit - Level XI (200/400) - 2018/04/20 10:04:14 ET
Table '2282606587 6' 9-max Seat #2 is the button
Seat 1: Danillo.G007 (16125 in chips) 
Seat 2: Advenator (15783 in chips) 
Seat 3: Vlad0184 (8174 in chips) 
Seat 4: KickAssPoker#1 (58010 in chips) 
Seat 5: Ariguzblack (3460 in chips) 
Seat 6: tuvshin777 (17302 in chips) 
Seat 7: 1JORSON (9497 in chips) 
Seat 8: ollikahn23 (8632 in chips) 
Seat 9: pokermanga (25565 in chips) 
Danillo.G007: posts the ante 50
Advenator: posts the ante 50
Vlad0184: posts the ante 50
KickAssPoker#1: posts the ante 50
Ariguzblack: posts the ante 50
tuvshin777: posts the ante 50
1JORSON: posts the ante 50
ollikahn23: posts the ante 50
pokermanga: posts the ante 50
Vlad0184: posts small blind 200
KickAssPoker#1: posts big blind 400
*** HOLE CARDS ***
Dealt to ollikahn23 [3s Kh]
Ariguzblack: folds 
tuvshin777: folds 
1JORSON: folds 
ollikahn23: folds 
pokermanga: folds 
Danillo.G007: folds 
Advenator: folds 
Vlad0184: folds 
Uncalled bet (200) returned to KickAssPoker#1
KickAssPoker#1 collected 850 from pot
KickAssPoker#1: doesn't show hand 
*** SUMMARY ***
Total pot 850 | Rake 0 
Seat 1: Danillo.G007 folded before Flop (didn't bet)
Seat 2: Advenator (button) folded before Flop (didn't bet)
Seat 3: Vlad0184 (small blind) folded before Flop
Seat 4: KickAssPoker#1 (big blind) collected (850)
Seat 5: Ariguzblack folded before Flop (didn't bet)
Seat 6: tuvshin777 folded before Flop (didn't bet)
Seat 7: 1JORSON folded before Flop (didn't bet)
Seat 8: ollikahn23 folded before Flop (didn't bet)
Seat 9: pokermanga folded before Flop (didn't bet)



PokerStars Hand #185454297440: Tournament #2282606587, $13.37+$1.63 USD Hold'em No Limit - Level XII (250/500) - 2018/04/20 10:04:34 ET
Table '2282606587 6' 9-max Seat #3 is the button
Seat 1: Danillo.G007 (16075 in chips) 
Seat 2: Advenator (15733 in chips) 
Seat 3: Vlad0184 (7924 in chips) 
Seat 4: KickAssPoker#1 (58610 in chips) 
Seat 5: Ariguzblack (3410 in chips) 
Seat 6: tuvshin777 (17252 in chips) 
Seat 7: 1JORSON (9447 in chips) 
Seat 8: ollikahn23 (8582 in chips) 
Seat 9: pokermanga (25515 in chips) 
Danillo.G007: posts the ante 60
Advenator: posts the ante 60
Vlad0184: posts the ante 60
KickAssPoker#1: posts the ante 60
Ariguzblack: posts the ante 60
tuvshin777: posts the ante 60
1JORSON: posts the ante 60
ollikahn23: posts the ante 60
pokermanga: posts the ante 60
KickAssPoker#1: posts small blind 250
Ariguzblack: posts big blind 500
*** HOLE CARDS ***
Dealt to ollikahn23 [7d 9h]
tuvshin777: folds 
1JORSON: folds 
ollikahn23: folds 
pokermanga: folds 
Danillo.G007: folds 
Advenator: folds 
Vlad0184: raises 500 to 1000
KickAssPoker#1: folds 
Ariguzblack: folds 
Uncalled bet (500) returned to Vlad0184
Vlad0184 collected 1790 from pot
*** SUMMARY ***
Total pot 1790 | Rake 0 
Seat 1: Danillo.G007 folded before Flop (didn't bet)
Seat 2: Advenator folded before Flop (didn't bet)
Seat 3: Vlad0184 (button) collected (1790)
Seat 4: KickAssPoker#1 (small blind) folded before Flop
Seat 5: Ariguzblack (big blind) folded before Flop
Seat 6: tuvshin777 folded before Flop (didn't bet)
Seat 7: 1JORSON folded before Flop (didn't bet)
Seat 8: ollikahn23 folded before Flop (didn't bet)
Seat 9: pokermanga folded before Flop (didn't bet)



PokerStars Hand #185454318600: Tournament #2282606587, $13.37+$1.63 USD Hold'em No Limit - Level XII (250/500) - 2018/04/20 10:05:17 ET
Table '2282606587 6' 9-max Seat #4 is the button
Seat 1: Danillo.G007 (16015 in chips) 
Seat 2: Advenator (15673 in chips) 
Seat 3: Vlad0184 (9154 in chips) 
Seat 4: KickAssPoker#1 (58300 in chips) 
Seat 5: Ariguzblack (2850 in chips) 
Seat 6: tuvshin777 (17192 in chips) 
Seat 7: 1JORSON (9387 in chips) 
Seat 8: ollikahn23 (8522 in chips) 
Seat 9: pokermanga (25455 in chips) 
Danillo.G007: posts the ante 60
Advenator: posts the ante 60
Vlad0184: posts the ante 60
KickAssPoker#1: posts the ante 60
Ariguzblack: posts the ante 60
tuvshin777: posts the ante 60
1JORSON: posts the ante 60
ollikahn23: posts the ante 60
pokermanga: posts the ante 60
Ariguzblack: posts small blind 250
tuvshin777: posts big blind 500
*** HOLE CARDS ***
Dealt to ollikahn23 [8h 9d]
1JORSON: folds 
ollikahn23: folds 
pokermanga: folds 
Danillo.G007: folds 
Advenator: folds 
Vlad0184: folds 
KickAssPoker#1: raises 1200 to 1700
Ariguzblack: raises 1090 to 2790 and is all-in
tuvshin777: folds 
KickAssPoker#1: calls 1090
*** FLOP *** [Js 8c 9s]
*** TURN *** [Js 8c 9s] [3c]
*** RIVER *** [Js 8c 9s 3c] [Qs]
*** SHOW DOWN ***
Ariguzblack: shows [Jc As] (a pair of Jacks)
KickAssPoker#1: shows [4s 2s] (a flush, Queen high)
KickAssPoker#1 collected 6620 from pot
Ariguzblack finished the tournament in 69th place
*** SUMMARY ***
Total pot 6620 | Rake 0 
Board [Js 8c 9s 3c Qs]
Seat 1: Danillo.G007 folded before Flop (didn't bet)
Seat 2: Advenator folded before Flop (didn't bet)
Seat 3: Vlad0184 folded before Flop (didn't bet)
Seat 4: KickAssPoker#1 (button) showed [4s 2s] and won (6620) with a flush, Queen high
Seat 5: Ariguzblack (small blind) showed [Jc As] and lost with a pair of Jacks
Seat 6: tuvshin777 (big blind) folded before Flop
Seat 7: 1JORSON folded before Flop (didn't bet)
Seat 8: ollikahn23 folded before Flop (didn't bet)
Seat 9: pokermanga folded before Flop (didn't bet)



PokerStars Hand #185454338752: Tournament #2282606587, $13.37+$1.63 USD Hold'em No Limit - Level XII (250/500) - 2018/04/20 10:05:58 ET
Table '2282606587 6' 9-max Seat #6 is the button
Seat 1: Danillo.G007 (15955 in chips) 
Seat 2: Advenator (15613 in chips) 
Seat 3: Vlad0184 (9094 in chips) 
Seat 4: KickAssPoker#1 (62070 in chips) 
Seat 6: tuvshin777 (16632 in chips) 
Seat 7: 1JORSON (9327 in chips) 
Seat 8: ollikahn23 (8462 in chips) 
Seat 9: pokermanga (25395 in chips) 
Danillo.G007: posts the ante 60
Advenator: posts the ante 60
Vlad0184: posts the ante 60
KickAssPoker#1: posts the ante 60
tuvshin777: posts the ante 60
1JORSON: posts the ante 60
ollikahn23: posts the ante 60
pokermanga: posts the ante 60
1JORSON: posts small blind 250
ollikahn23: posts big blind 500
*** HOLE CARDS ***
Dealt to ollikahn23 [2d Kh]
pokermanga: folds 
Danillo.G007: folds 
Advenator: folds 
Vlad0184: folds 
KickAssPoker#1: folds 
tuvshin777: folds 
1JORSON: folds 
Uncalled bet (250) returned to ollikahn23
ollikahn23 collected 980 from pot
ollikahn23: doesn't show hand 
*** SUMMARY ***
Total pot 980 | Rake 0 
Seat 1: Danillo.G007 folded before Flop (didn't bet)
Seat 2: Advenator folded before Flop (didn't bet)
Seat 3: Vlad0184 folded before Flop (didn't bet)
Seat 4: KickAssPoker#1 folded before Flop (didn't bet)
Seat 6: tuvshin777 (button) folded before Flop (didn't bet)
Seat 7: 1JORSON (small blind) folded before Flop
Seat 8: ollikahn23 (big blind) collected (980)
Seat 9: pokermanga folded before Flop (didn't bet)



PokerStars Hand #185454352667: Tournament #2282606587, $13.37+$1.63 USD Hold'em No Limit - Level XII (250/500) - 2018/04/20 10:06:26 ET
Table '2282606587 6' 9-max Seat #7 is the button
Seat 1: Danillo.G007 (15895 in chips) 
Seat 2: Advenator (15553 in chips) 
Seat 3: Vlad0184 (9034 in chips) 
Seat 4: KickAssPoker#1 (62010 in chips) 
Seat 6: tuvshin777 (16572 in chips) 
Seat 7: 1JORSON (9017 in chips) 
Seat 8: ollikahn23 (9132 in chips) 
Seat 9: pokermanga (25335 in chips) 
Danillo.G007: posts the ante 60
Advenator: posts the ante 60
Vlad0184: posts the ante 60
KickAssPoker#1: posts the ante 60
tuvshin777: posts the ante 60
1JORSON: posts the ante 60
ollikahn23: posts the ante 60
pokermanga: posts the ante 60
ollikahn23: posts small blind 250
pokermanga: posts big blind 500
*** HOLE CARDS ***
Dealt to ollikahn23 [2d Qh]
Danillo.G007: folds 
Advenator: raises 550 to 1050
Vlad0184: folds 
KickAssPoker#1: raises 2550 to 3600
tuvshin777: folds 
1JORSON: folds 
ollikahn23: folds 
pokermanga: raises 21675 to 25275 and is all-in
Advenator: folds 
KickAssPoker#1: folds 
Uncalled bet (21675) returned to pokermanga
pokermanga collected 8980 from pot
pokermanga: doesn't show hand 
*** SUMMARY ***
Total pot 8980 | Rake 0 
Seat 1: Danillo.G007 folded before Flop (didn't bet)
Seat 2: Advenator folded before Flop
Seat 3: Vlad0184 folded before Flop (didn't bet)
Seat 4: KickAssPoker#1 folded before Flop
Seat 6: tuvshin777 folded before Flop (didn't bet)
Seat 7: 1JORSON (button) folded before Flop (didn't bet)
Seat 8: ollikahn23 (small blind) folded before Flop
Seat 9: pokermanga (big blind) collected (8980)



PokerStars Hand #185454381475: Tournament #2282606587, $13.37+$1.63 USD Hold'em No Limit - Level XII (250/500) - 2018/04/20 10:07:25 ET
Table '2282606587 6' 9-max Seat #8 is the button
Seat 1: Danillo.G007 (15835 in chips) 
Seat 2: Advenator (14443 in chips) 
Seat 3: Vlad0184 (8974 in chips) 
Seat 4: KickAssPoker#1 (58350 in chips) 
Seat 6: tuvshin777 (16512 in chips) 
Seat 7: 1JORSON (8957 in chips) 
Seat 8: ollikahn23 (8822 in chips) 
Seat 9: pokermanga (30655 in chips) 
Danillo.G007: posts the ante 60
Advenator: posts the ante 60
Vlad0184: posts the ante 60
KickAssPoker#1: posts the ante 60
tuvshin777: posts the ante 60
1JORSON: posts the ante 60
ollikahn23: posts the ante 60
pokermanga: posts the ante 60
pokermanga: posts small blind 250
Danillo.G007: posts big blind 500
*** HOLE CARDS ***
Dealt to ollikahn23 [4h Kc]
Advenator: folds 
Vlad0184: folds 
KickAssPoker#1: folds 
tuvshin777: folds 
1JORSON: raises 8397 to 8897 and is all-in
ollikahn23: folds 
pokermanga: folds 
Danillo.G007: folds 
Uncalled bet (8397) returned to 1JORSON
1JORSON collected 1730 from pot
*** SUMMARY ***
Total pot 1730 | Rake 0 
Seat 1: Danillo.G007 (big blind) folded before Flop
Seat 2: Advenator folded before Flop (didn't bet)
Seat 3: Vlad0184 folded before Flop (didn't bet)
Seat 4: KickAssPoker#1 folded before Flop (didn't bet)
Seat 6: tuvshin777 folded before Flop (didn't bet)
Seat 7: 1JORSON collected (1730)
Seat 8: ollikahn23 (button) folded before Flop (didn't bet)
Seat 9: pokermanga (small blind) folded before Flop



PokerStars Hand #185454393517: Tournament #2282606587, $13.37+$1.63 USD Hold'em No Limit - Level XII (250/500) - 2018/04/20 10:07:49 ET
Table '2282606587 6' 9-max Seat #9 is the button
Seat 1: Danillo.G007 (15275 in chips) 
Seat 2: Advenator (14383 in chips) 
Seat 3: Vlad0184 (8914 in chips) 
Seat 4: KickAssPoker#1 (58290 in chips) 
Seat 6: tuvshin777 (16452 in chips) 
Seat 7: 1JORSON (10127 in chips) 
Seat 8: ollikahn23 (8762 in chips) 
Seat 9: pokermanga (30345 in chips) 
Danillo.G007: posts the ante 60
Advenator: posts the ante 60
Vlad0184: posts the ante 60
KickAssPoker#1: posts the ante 60
tuvshin777: posts the ante 60
1JORSON: posts the ante 60
ollikahn23: posts the ante 60
pokermanga: posts the ante 60
Danillo.G007: posts small blind 250
Advenator: posts big blind 500
*** HOLE CARDS ***
Dealt to ollikahn23 [2c 8d]
Vlad0184: folds 
KickAssPoker#1: folds 
tuvshin777: folds 
1JORSON: folds 
ollikahn23: raises 8202 to 8702 and is all-in
pokermanga: folds 
Danillo.G007: folds 
Advenator: folds 
Uncalled bet (8202) returned to ollikahn23
ollikahn23 collected 1730 from pot
ollikahn23: doesn't show hand 
*** SUMMARY ***
Total pot 1730 | Rake 0 
Seat 1: Danillo.G007 (small blind) folded before Flop
Seat 2: Advenator (big blind) folded before Flop
Seat 3: Vlad0184 folded before Flop (didn't bet)
Seat 4: KickAssPoker#1 folded before Flop (didn't bet)
Seat 6: tuvshin777 folded before Flop (didn't bet)
Seat 7: 1JORSON folded before Flop (didn't bet)
Seat 8: ollikahn23 collected (1730)
Seat 9: pokermanga (button) folded before Flop (didn't bet)



PokerStars Hand #185454407821: Tournament #2282606587, $13.37+$1.63 USD Hold'em No Limit - Level XII (250/500) - 2018/04/20 10:08:19 ET
Table '2282606587 6' 9-max Seat #1 is the button
Seat 1: Danillo.G007 (14965 in chips) 
Seat 2: Advenator (13823 in chips) 
Seat 3: Vlad0184 (8854 in chips) 
Seat 4: KickAssPoker#1 (58230 in chips) 
Seat 6: tuvshin777 (16392 in chips) 
Seat 7: 1JORSON (10067 in chips) 
Seat 8: ollikahn23 (9932 in chips) 
Seat 9: pokermanga (30285 in chips) 
Danillo.G007: posts the ante 60
Advenator: posts the ante 60
Vlad0184: posts the ante 60
KickAssPoker#1: posts the ante 60
tuvshin777: posts the ante 60
1JORSON: posts the ante 60
ollikahn23: posts the ante 60
pokermanga: posts the ante 60
Advenator: posts small blind 250
Vlad0184: posts big blind 500
*** HOLE CARDS ***
Dealt to ollikahn23 [4d Tc]
KickAssPoker#1: folds 
tuvshin777: folds 
1JORSON: raises 9507 to 10007 and is all-in
ollikahn23: folds 
pokermanga: folds 
Danillo.G007: folds 
Advenator: folds 
Vlad0184: folds 
Uncalled bet (9507) returned to 1JORSON
1JORSON collected 1730 from pot
*** SUMMARY ***
Total pot 1730 | Rake 0 
Seat 1: Danillo.G007 (button) folded before Flop (didn't bet)
Seat 2: Advenator (small blind) folded before Flop
Seat 3: Vlad0184 (big blind) folded before Flop
Seat 4: KickAssPoker#1 folded before Flop (didn't bet)
Seat 6: tuvshin777 folded before Flop (didn't bet)
Seat 7: 1JORSON collected (1730)
Seat 8: ollikahn23 folded before Flop (didn't bet)
Seat 9: pokermanga folded before Flop (didn't bet)



PokerStars Hand #185454418897: Tournament #2282606587, $13.37+$1.63 USD Hold'em No Limit - Level XII (250/500) - 2018/04/20 10:08:41 ET
Table '2282606587 6' 9-max Seat #2 is the button
Seat 1: Danillo.G007 (14905 in chips) 
Seat 2: Advenator (13513 in chips) 
Seat 3: Vlad0184 (8294 in chips) 
Seat 4: KickAssPoker#1 (58170 in chips) 
Seat 6: tuvshin777 (16332 in chips) 
Seat 7: 1JORSON (11237 in chips) 
Seat 8: ollikahn23 (9872 in chips) 
Seat 9: pokermanga (30225 in chips) 
Danillo.G007: posts the ante 60
Advenator: posts the ante 60
Vlad0184: posts the ante 60
KickAssPoker#1: posts the ante 60
tuvshin777: posts the ante 60
1JORSON: posts the ante 60
ollikahn23: posts the ante 60
pokermanga: posts the ante 60
Vlad0184: posts small blind 250
KickAssPoker#1: posts big blind 500
*** HOLE CARDS ***
Dealt to ollikahn23 [Jc Ks]
tuvshin777: folds 
1JORSON: folds 
ollikahn23: raises 9312 to 9812 and is all-in
pokermanga: folds 
Danillo.G007: raises 5033 to 14845 and is all-in
Advenator: folds 
Vlad0184: folds 
KickAssPoker#1: folds 
Uncalled bet (5033) returned to Danillo.G007
*** FLOP *** [8s Js 4c]
*** TURN *** [8s Js 4c] [2s]
*** RIVER *** [8s Js 4c 2s] [Jd]
*** SHOW DOWN ***
ollikahn23: shows [Jc Ks] (three of a kind, Jacks)
Danillo.G007: shows [As Qs] (a flush, Ace high)
Danillo.G007 collected 20854 from pot
ollikahn23 finished the tournament in 63rd place
*** SUMMARY ***
Total pot 20854 | Rake 0 
Board [8s Js 4c 2s Jd]
Seat 1: Danillo.G007 showed [As Qs] and won (20854) with a flush, Ace high
Seat 2: Advenator (button) folded before Flop (didn't bet)
Seat 3: Vlad0184 (small blind) folded before Flop
Seat 4: KickAssPoker#1 (big blind) folded before Flop
Seat 6: tuvshin777 folded before Flop (didn't bet)
Seat 7: 1JORSON folded before Flop (didn't bet)
Seat 8: ollikahn23 showed [Jc Ks] and lost with three of a kind, Jacks
Seat 9: pokermanga folded before Flop (didn't bet)



